----------------------------------------------------------------------------------------------------------------------------------------------------------------------------------------------------------------------------------------------------
----------------------------------------------------------------------------------------------------------------------------------------------------------------------------------------------------------------------------------------------------
----------------------------------------------------------------------------------------------------------------------------------------------------------------------------------------------------------------------------------------------------
-----------------------------------------------------------------------------------------------------------------------------------------------------SSSSSSSSSSSSSSSSSSSSSSSSSSSSSSSSSSSSSSS--------------------------------------------------------
----------------------------------------------------------------------------------------------------------------------------------------------------------------------------------------------------------------------------------------------------
-------------------------------------------------------------------------------------k-----------------------------------------------------------------------------------------------------------------------------------------------y--------------
-------------2----------------------------------------------------------------------##-------------------------------------SS----S!!S--------------------------------------------------------------------------y---------------------##-------------
-----------------------------------------------------------------------------------###-----------------------------------------------------------------------------------------------------------------------#SSS------------------y###-------------
--------------------------y------------------------------------------#-----------k####--------------------------TT------------------------------------------------------------------------------oo----------##---------------------####-------------
------oo------------------#SS-?Q-------------------------------k-----#-----------#####--------------------------TT-----------------------------------------------------------------------------------------###1--------------o----#####-------------
-------------2-----------##-------------------------------C--CSSS----#----------######-----------------#LSS-----##----------------SS------#--#-----------------tt------------------------g##---------------###-------------------######---C---------
------------------------###------------------------#----------K-----##---------#######-----------------#---------------------------------##--##----------TT----tt-----------SS-----------###-------------#-###--SSS-------TT----#######-------------
-----------------------####-------y------------K---#----------------##--------########-----------------#-----------*---TT---------------###--###---------TT----tt----TT-----SS---------g####------------##-###------------TT---########-------------
-----------y--y-------#####---SSSSS----------------#-----gg-----K---##-------#########--------#------kk#-----------*---TT----gg-g-g----####--####-----g--TT----tt--g-TT-----SS---------#####---------------###---------y--TT--#########--------#----
XXXXXXXXXXXXXXXXXXXXXXXXXXX-------XX-XXXXXXXXXXXX--XXXXXXXXXXXXXXXXXXX---XXXXXXXXXXXXXXXXXXXXXXXXXXXXXXXXXXX---XXXXXXXXXXXXXXXXXXXXXXXXXXXXXXXXXXXXXXXXXXXXXXXXXXXXXXXXXXX--XX--XXXXXXXXXXXX-----XXXXXXXXXXXXXXXX---XXXXXXXXXXXXXXXXXXXXXXXXXXXXXXXX
XXXXXXXXXXXXXXXXXXXXXXXXXXX-------XX-XXXXXXXXXXXX--XXXXXXXXXXXXXXXXXXX---XXXXXXXXXXXXXXXXXXXXXXXXXXXXXXXXXXX---XXXXXXXXXXXXXXXXXXXXXXXXXXXXXXXXXXXXXXXXXXXXXXXXXXXXXXXXXXX--XX--XXXXXXXXXXXX-----XXXXXXXXXXXXXXXX---XXXXXXXXXXXXXXXXXXXXXXXXXXXXXXXX