----------------------------------------------------------------------------------------------------------------------------------------------------------------------------------------------------------------------------------------------------------------------------------------
----------------------------------------------------------------------------------------------------------------------------------------------------------------------------------------------------------------------------------------------------------------------------------------
----------------------------------------------------------------------------------------------------------------------------------------------------------------------------------------------------------------------------------------------------------------------------------------
----------------------------------------------------------------------------------------------------------------------------------------------------------------------------------------------------------------------------------------------------------------------------------------
----------------------------------------------------------------------------------------------------------------------------------------------------------------------------------------------------------------------------------------------------------------------------------------
----------------------------------------------------------------------------------------------------------------------------------------------------------------------------------------------------------------------------------------------------------------------------------------
---------!----------------------------------SSSSSS!---------------------------------------Q------------------------------------------------------------------------SUS---------------------------------------------------------------------Q-Q------------------------------------------
---------------------------------------------------------------------------------------------------------------------------------------S---------------------------------------------------------------------------------------------------------------------------oooo-----------------
----------------------------------------------------------------------------------------------------------------------------------------------------------------------------------------------------------------------------------------------------------------------------------------
-----------------------------------------------------------------------------------------------------------oo---------------------------------------------------------------------------------------------------------------------------------------------------------------------------
-------S@S!S---------------------tt---------SSSSSSS---------SSS---------TT----------------?---------------o--o-----------------------------------------------------####--------------------------------------------------------------------Q-Q------------------------------------------
-------------------------tt------tt-------------------#-------K---TT----TT------------TT-----------------------------------------------------------------------------------------------------#-------------------------------TT-------------------------------------tt------------------
---------------tt--------tt------tt-------------------#-----------TT----TT------------TT-----------------------------------------------#------------------------------------------------*----#-------------------------------TT-------------------------------------tt------------------
--------g------tt--------tt-g----tt-----g-g-----------#-----------TT---gTT------------TT--------------------------------k-------ggg----#-------k-----kkk-------kk----------------ggg----*----#----ggg--k----ggg------------kkTT--y-------------y--------------------tt----k---ggg-------
XXXXXXXXXXXXXXXXXXXXXXXXXXXXXXXXXXXXXXXXXXXXXXXXXXXX--XXXXXXXXXXXXXXXXXXXXXXXXX---XXXXXXXXXXXXXXX--XXXXXXXXXXXXXXXXXXXXXXXXXXXXXXXXX--XXX--XXXXXXXXXXXXXXXXXXXXXXXXXX----XXXXXXXXXXXXXXXXXX--XXXXXXXXXXXXXXXXXXXXXXXXXXXXXXXXXXXXXXXXXXXXXXXXXXXXXXXXXXXX----XXXXXXXXXXXXXXXXXXXXXXXXXXX
XXXXXXXXXXXXXXXXXXXXXXXXXXXXXXXXXXXXXXXXXXXXXXXXXXXX--XXXXXXXXXXXXXXXXXXXXXXXXX---XXXXXXXXXXXXXXX--XXXXXXXXXXXXXXXXXXXXXXXXXXXXXXXXX--XXX--XXXXXXXXXXXXXXXXXXXXXXXXXX----XXXXXXXXXXXXXXXXXX--XXXXXXXXXXXXXXXXXXXXXXXXXXXXXXXXXXXXXXXXXXXXXXXXXXXXXXXXXXXX----XXXXXXXXXXXXXXXXXXXXXXXXXXX