------------------------------------------------------------------------------------------------------------------------------------------------------------------------
------------------------------------------------------------------------------------------------------------------------------------------------------------------------
------------------------------------------------------------------------------------------------------------------------------------------------------------------------
------------------------------------------------------------------------------------------------------------------------------------------------------------------------
------------------------------------------------------------------------------------------------------------------------------------------------------------------------
---------------------------------------------------------------------------oo-------------------------------------------------------------------------------------------
---------------------------------------US---------------------------------@SS-------------------------------------------------------------------------------------------
-------------------------------------------------------------------------------------------------------------y----------------------------------------------------------
----------------------------------------------------------##--------------------------------------TT---------S----------------------------------------------------------
------------------------------------------------------g--###------------------SSS-----------------TT--------------------------------------------------------------------
--------------------------------------###---SSC-------#--###-------!!!!!-2---------------#LSS-----##----------SC----------------##--------------------------------------
-------------#-------------------y-####-------------g##--###-----------------------------#-------------------------------------###------tt------------------------TT----
-------------#------------------#####---------------###--###-----------------------------#-----------*---TT----SSS------------#####-----tt------------------------TT----
-------------#----y--y----------###----------------####--###------------------oo-------kk#-----------*---TT------------------######-----tt---------------------gggTT----
XXXXXXXXXXXXXX--XXXXXXXXXXXXXXXXXX------XX--XXXXXXXXXXX--XXXXXXXXXXXXXXXXXXXXXXXXXXXXXXXXXXXXX---XXXXXXXXXXXX-----XXXXXXXXXXXXXXXXXXXXXXXXXXXXXXXXXXXXXXXXXXXXXXXXXXXXXX
XXXXXXXXXXXXXX--XXXXXXXXXXXXXXXXXX------XX--XXXXXXXXXXX--XXXXXXXXXXXXXXXXXXXXXXXXXXXXXXXXXXXXX---XXXXXXXXXXXX-----XXXXXXXXXXXXXXXXXXXXXXXXXXXXXXXXXXXXXXXXXXXXXXXXXXXXXX