---------------------------------------------------------------------------------------------------------------------------------------------------------------------------------------
---------------------------------------------------------------------------------------------------------------------------------------------------------------------------------------
---------------------------------------------------------------------------------------------------------------------------------------------------------------------------------------
---------------------------------------------------------------------------------------------------------------------------------------------------------------------------------------
---------------------------------------------------------------------------------------------------------------------------------------------------------------------------------------
---------------------------------------------------------------------------------------------------------------------------------------------------------------------------------------
-----------------------------US-----------------------------------------------------y---------------------2--------------------------------------------------------------##------------
----------------------------------------------------------------------------------#SSS---------------------------------------------------------y-------------------------##------------
---------------------------------------------------------------------oo----------##------------------------------------y---------------------#SS----------------------y--##------------
-----------------------------------------------------------------y--------------###1--------------ooo------------------#SS-?Q---------------##------------------------#--##------------
---------QQ-----------------###---SSC------------------ooo-------##-------------###-----------------------2-----------##-------------------###--SC-------------------##--##------------
-----------------------y-####-----------------------------------###-----------#-###--SSS-------TT--------------------###------------------####---------------------y###--##------------
--------------------y-#####------------------------------------####----------##-###------------TT-------------------####-------y---------#####---SSS---------------####--##------------
-------------------######-------------------y-y---------------#####-------------###---------y--TT-------y--y-------#####---SSSSS-----y--######--------------------#####--##--------F---
XXXXXXXXXXXXX--XXXXXXXXX------XX--XXXXXXXXXXXXXXXX--XXXXXXXXXXXXXXX---XXXXXXXXXXXXXXXX---XXXXXXXXXXXXXXXXXXXXXXXXXXXXXXX-------XX-XXXXXXXXXXXX------XXXXXXXXX---XXXXXXX--XXXXXXXXXXXXXX
XXXXXXXXXXXXX--XXXXXXXXX------XX--XXXXXXXXXXXXXXXX--XXXXXXXXXXXXXXX---XXXXXXXXXXXXXXXX---XXXXXXXXXXXXXXXXXXXXXXXXXXXXXXX-------XX-XXXXXXXXXXXX------XXXXXXXXX---XXXXXXX--XXXXXXXXXXXXXX