----------------------------------------------------------------------------------------------------------------------------------------------------------------------------------------------------------------------
----------------------------------------------------------------------------------------------------------------------------------------------------------------------------------------------------------------------
----------------------------------------------------------------------------------------------------------------------------------------------------------------------------------------------------------------------
----------------------------------------------------------------------------------------------------------------------------------------------------------------------------------------------------------------------
---------------------------------------------------------------------------------------------------------------------------------------------------------------------------------------------------------K------------
--------------------------------------------------------------g----------------------------------------------------k--------------------------------------------------------------------------------------------------
------------------SCS-----------------------------------------SSSSS-----SSSSS---------------------------------S---SSSSSSSSS------------US---SS-------------SSS-------------------------------------------##-----------
---------------------------TT-----------------------------------------------------------------------------TT------------------------------------------------------TT------------------------------------###-----------
---------------------------TT----------------------------TT-----------------------TT----------------------TT------------------------------------------------------TT-----------------------------------####-----------
---------------------------##----------------------TT----TT-----------------------TT----------------------TT-------------------------SS---------------------------TT----------------------------------#####-----------
-----SSS------tt---2---TT----------------tt---SU---TT----##------------------2----TT-------------tt------S##S------------------------------SSS---------#---SSS----##-----TT-------TT----------------TT#####-----------
--------------tt-------TT-------------K--tt--------TT----------------------TT-----TT-----TT------tt-----------------------------------------------#-TT-#-----------------TT-----TTTT----TT----------TT#####-----------
--------------tt-------TT-----TTTT-------tt--------TT---------TT-----tt----TT--TT-TT-----TT------tt-TT--------TT--------------TT--TT-------------##-TT-##----------------TT---TTTTTT----TT---------#TT#####--------F--
--------------tt----k--TT-----TTTT-------tt------k-TT---------TT-----tt----TT--TT-TT---k-TT------tt-TT--------TT--------------TT--TT------------###-TT-##---------k--g---TT---TTTTTT----TT--------##TT#####--------#--
XXXXXXXXXXXXXXXXXXXXXXXXXXXXXXXXXXXXXXXXXXXXXXXXXXXXXXXXXXXXXXXXXXXXXXXXXXXXXXXXXXXXXXXXXXXXXXXXXXXXXXXXXXXXXXXXXXXXXX------XXXXXXXXXXXX-X-XXXXXXXX-XXXXXXXXXXXXXXXXXXXXXXXXXXXXXXXXXXXXXXXXXXXXXXXXXXXXXXXXXXXXXXXXXX
XXXXXXXXXXXXXXXXXXXXXXXXXXXXXXXXXXXXXXXXXXXXXXXXXXXXXXXXXXXXXXXXXXXXXXXXXXXXXXXXXXXXXXXXXXXXXXXXXXXXXXXXXXXXXXXXXXXXXX------XXXXXXXXXXXX-X-XXXXXXXX-XXXXXXXXXXXXXXXXXXXXXXXXXXXXXXXXXXXXXXXXXXXXXXXXXXXXXXXXXXXXXXXXXX