-----------------------------------------------------------------------------------------------------------------------------------------------------------------------------------------------------------------------
-----------------------------------------------------------------------------------------------------------------------------------------------------------------------------------------------------------------------
-----------------------------------------------------------------------------------------------------------------------------------------------------------------------------------------------------------------------
---------------------------------------------------------------------------------------------------------------------SSSSSSSSSSSSSSSSSSSSSSS-------------------SSSSSSSSSSSSSSSSSSSSSSSSSSSSSSSSSSSSSSSSSSSSSSSSSSSS----
---------------------------------------------------------------------------------------------------------------------------------------------------------------SSSSSSSSSSS--------------------SSSSSSSSSSSSSSSSSSSSS----
-------------------------------------------------oo------------------------------------------------------------------------------------------------------------SSSSSSSSSSS--------------------SSSSSSSSSSSSSSSSSSSSS----
-----------------------y-------------------------SSSS----------------------------------------------------------------------------------------------------------SSSSSSSSSSS--------------------SSSSSSSSSSSSSSSSSSSSS----
---------------------#SSS-----------------------------------------------------------------------------------------------------------------------------------------------------TT---------------------------------------
--------oo----------##--------------------------------------------------------------------------------------------------------------------------------------------------------TT---------------------------------------
-------------------###1--------------o------------------------------------------------------Q--?----------------------------------------C--------------Q--?----ooooooo--------TT---------------------------------------
-------------------###-----------------------@----------------------------------#--------Q---------S-----------------@QQQQ--------#-#---------------Q---------SSSSSSSS----#---TT----------------SSSSSSU-SSSSSSSSSSS----
-----------------#-###--SSS-------TT--------------------------------------------#-----------------------------------------------#-#-#-#---#------------------------------##---TT---SS-----------SSSSS---SSSSSSSSSSS----
----------------##-###------------TT----K---------tt---------------------------K#-------------------------------------------g-#-#-#-#-#---#-----------------------------###---TT---SS-----------SSSSS---SSSSSSSSSSS----
-------------------###---------y--TT-------K------tt-------------ggg------------#-----------------K-----k------ggg---------g#-#-#-#-#-#-E-#------------------K----kk---####--kTT---SS----------------oooSSSSSSSSSSS----
XXXXXX---XXXXXXXXXXXXXXXX---XXXXXXXXXXXXXXXXXXX---XX--XXXXXXXXXXXXXXXXXXXXXXXXXXXXXXXXXXXXXXXXXXXXXXXXXXXXXXXXXXXXXXXXXXXXXXXXXXXXXXXXXXXXXXXXXXXXXXXXXXXXXXXXXXXXXXXXXXXXXXXXXXX--XX--XX--X---XXXXXXXXXXXXXXXXXXXXXXXX
XXXXXX---XXXXXXXXXXXXXXXX---XXXXXXXXXXXXXXXXXXX---XX--XXXXXXXXXXXXXXXXXXXXXXXXXXXXXXXXXXXXXXXXXXXXXXXXXXXXXXXXXXXXXXXXXXXXXXXXXXXXXXXXXXXXXXXXXXXXXXXXXXXXXXXXXXXXXXXXXXXXXXXXXXX--XX--XX--X---XXXXXXXXXXXXXXXXXXXXXXXX