--------------------------------------------------------------------------------------------------------------------------------------------------------------------------------------------------------------------------------------------------------------
--------------------------------------------------------------------------------------------------------------------------------------------------------------------------------------------------------------------------------------------------------------
--------------------------------------------------------------------------------------------------------------------------------------------------------------------------------------------------------------------------------------------------------------
--------------------------------------------------------------------------------------------------------------------------------------------------------------------------------------------------------------------------------------------------------------
--------------------------------------------------------------------------------------------------------------------------------------------------------------------------------------------------------------------------------------------------------------
-----------------------------------------------------------------------------------------------------------------------------------------------------------------------------------------------------------------------------------------k--------------------
-------------------------------------LSSS---------------------------------------------------------SUS-----------------------------------------------------------------------------------------------------------------------------------SQS--SQS--------------
--------------------------------------------------------------------------------------------------------------------------------------------------------------------S-----------------------------------------------------------------------------------------
---------------------------------g---------------------------TT--------------------------------------------------------------------------------------------------------------------------------------------------------------TT-------------------------------
---------------------------------#---------------------------TT--------------------------------------------------------------------------------------------------------------------------------------------------------------TT-------------------------------
--------------------------S-----##---2-----#--------#LSS-----##-----------------------------------####--------------------------------------------------------------------------------------------------------------#LSS-----##---------SQS--S?S--------SC----
-------------------------------###---------#--------#--------------------------#--------------------------------------------#---------------------------------------------------------------------------------------#-----------------------------------------
------------------------------####---------#--------#-----------*---TT---------#---------------------------------------*----#---------------------------------------#-----------------------------------------------#-----------*---TT------------------------
----------kkk-------kk-------#####----kk---#------kk#-----------*---TT---------#----y--y------------------------ggg----*----#----ggg--k----ggg-------k-------ggg----#-------k-----kkk-------kk--------ggg---------kk#-----------*---TT-------ggg--------K-----
XXXXXXXXXXXXXXXXXXXXXXXXXXXXXXXXXXXXXXXXXXXXXXXXXXXXXXXXX---XXXXXXXXXXXXXXXXXXXX--XXXXXXXXXXXXXXXXXX----XXXXXXXXXXXXXXXXXX--XXXXXXXXXXXXXXXXXXXXXXXXXXXXXXXXXXXXX--XXX--XXXXXXXXXXXXXXXXXXXXXXXXXXXXXXXXXXXXXXXXXXXXXXXXX---XXXXXXXXXXXXXXXXXXXXXXXXXXXXXXXXXX
XXXXXXXXXXXXXXXXXXXXXXXXXXXXXXXXXXXXXXXXXXXXXXXXXXXXXXXXX---XXXXXXXXXXXXXXXXXXXX--XXXXXXXXXXXXXXXXXX----XXXXXXXXXXXXXXXXXX--XXXXXXXXXXXXXXXXXXXXXXXXXXXXXXXXXXXXX--XXX--XXXXXXXXXXXXXXXXXXXXXXXXXXXXXXXXXXXXXXXXXXXXXXXXX---XXXXXXXXXXXXXXXXXXXXXXXXXXXXXXXXXX