----------------------------------------------------------------------------------------------------------------------------------------------------------------------------------------------------
----------------------------------------------------------------------------------------------------------------------------------------------------------------------------------------------------
----------------------------------------------------------------------------------------------------------------------------------------------------------------------------------------------------
----------------------------------------------------------------------------------------------------------------------------------------------------------------------------------------------------
----------------------------------------------------------------------------------------------------------------------------------------------------------------------------------------------------
------------------------------------------------------------------------------------------------------------------------------------------------k---------------------------------------k-----------
---------------------------------------------------------------------------1--------USS-----------------SSQSSS?SSS--------SSC------------------SQS--SQS--------------------------------##-----------
--------------------------------------------------------------------------------------------------------------------------------------------------------------------------------------###-----------
-------------------------------------------------------------------------------------------------------------------------------------g#---------------------------------#-----------k####-----------
------------Q--?-----------------------------------------------------------ggg----------------------------K---------------SSS-------g##---------------------------k-----#-----------#####-----------
---------Q---------SSS---------tt---------------------S--------------##########---#-------------TT------SSSSSSSSSSS-----------------###--------SQS--S?S--------SCSSS----#----------######-----------
---------------------K---TT----tt-----------------TT----------------##--------#---#-------------TT---------------------------------####--------------------------K-----##---------#######-----------
-------------------------TT----tt-----------------TT--------TT-----###--------#---##------------TT--------------------------------#####--------------------------------##--------########--------F--
-M----------------K------TT---gtt--------------gggTT------k-TT----####--------#---##--gg----k---TT--------------K----------------######------k------ggg--------K---K---##-------#########--------#--
XXXXXXXXXXXXXXXXXXXXXXXXXXXXXXXXXXXXXX---XXXXXXXXXXXXXXXXXXXXXXXXXXXXX--------X---XXXXXXXXXXXXXXXXXXXXXXXXXXXXXXXXXXXXXXX----XXXXXXXXXX--XXXXXXXXXXXXXXXXXXXXXXXXXXXXXXXX---XXXXXXXXXXXXXXXXXXXXXXXX
XXXXXXXXXXXXXXXXXXXXXXXXXXXXXXXXXXXXXX---XXXXXXXXXXXXXXXXXXXXXXXXXXXXX--------X---XXXXXXXXXXXXXXXXXXXXXXXXXXXXXXXXXXXXXXX----XXXXXXXXXX--XXXXXXXXXXXXXXXXXXXXXXXXXXXXXXXX---XXXXXXXXXXXXXXXXXXXXXXXX