---------------------------------------------------------------------------------------------------------------------------------------------------------------------------------------------------------------------------------------------------------------------------
---------------------------------------------------------------------------------------------------------------------------------------------------------------------------------------------------------------------------------------------------------------------------
---------------------------------------------------------------------------------------------------------------------------------------------------------------------------------------------------------------------------------------------------------------------------
---------------------------------------------------------------------------------------------------------------------------------------------------------------------------------------------------------------------------------------------------------------------------
---------------------------------------------------------------------------------------------------------------------------------------------------------------------------------------------------------------------------------------------------------------------------
---------------------------------------ooo---------------------------------------------------------------------------------------k-----------------------------------------------------------------------------------------------------------------------------------------
-----------------------------------------------SSSSS@----------!------------------------------------------------------------S---SSSSSSS@-------------------------------@-----------------------------------C------------------------------------------------##-------------
-------oooo------------oooo---------------------------------------------------------------------------------------------TT---------------------------------------------------------------------------------------------------------------------------------###-------------
-----------------------------------B------------------------------------------------------------------------------------TT---------------------------------------------------------------------------------------------------------TT---------------------####-------------
-----------------------------------b-----------ooo----------------------------------------------------------------------TT---------------------------------------------------------------------------------------------------------TT--------------------#####-------------
--------------------TT-----------####----------SSSSSS--------S@S!S---------------------tt----------------------tt------S##S------------@-------------------------------@----------------------------------SS--------------#LSS-----##-------------------######-------------
--------------------TT----------##---------------------------------------------tt------tt--------------TT------tt---------------------------------------------------------------------------------------------------------#----------------------------#######-------------
--------------------TT---------###-----------------------------------tt--------tt------tt--------------TT------tt-TT--------TT-----------#-------------------------------#------------------------------------------------#-----------*---TT----------########-------------
---------y------y---TT--------####-------k----------------K---g------tt--------tt-g----tt-----g-g----k-TT------tt-TT--------TT----------k#------------K-----------------k#------------K--------------------k-----X------kk#-----------*---TT-----ggg-#########--------S----
XXXXXXXXXXXXXXXXXXXXXXXXXXXXXXXXXXXXXXXXXXXX---XXXXXXXXXXXXXXXXXXXXXXXXXXXXXXXXXXXXXXXXXXXXXXXXXXXXXXXXXXXXXXXXXXXXXXXXXXXXXXXXXXXXX---XXX--XXXXXXXXXXXXXXXXXXXXXXXXXXXXXX--XXXXXXXXXXXXXXXXXXXXXXXXXXXXXXXXXXXXXXXXXXXXXXXXXXX---XXXXXXXXXXXXXXXXXXXXXXXXXXXXXXXXXXXXXXXXX
XXXXXXXXXXXXXXXXXXXXXXXXXXXXXXXXXXXXXXXXXXXX---XXXXXXXXXXXXXXXXXXXXXXXXXXXXXXXXXXXXXXXXXXXXXXXXXXXXXXXXXXXXXXXXXXXXXXXXXXXXXXXXXXXXX---XXX--XXXXXXXXXXXXXXXXXXXXXXXXXXXXXX--XXXXXXXXXXXXXXXXXXXXXXXXXXXXXXXXXXXXXXXXXXXXXXXXXXX---XXXXXXXXXXXXXXXXXXXXXXXXXXXXXXXXXXXXXXXXX