-------------------------------------------------------------------------------------------------------------------------------------------------------------------------------
-------------------------------------------------------------------------------------------------------------------------------------------------------------------------------
-------------------------------------------------------------------------------------------------------------------------------------------------------------------------------
------------------------------------SSSSSS-------------------------------------------------------------------------------------------------------------------------------------
-------------------------------------------------------------------------------------------------------------------------------------------------------------------------------
-------------------------------------------------------------------------------------------------------------------------------------------------------------------------------
----------------------------------------------------------------------------------------------------------Q---------------------------------1--------USS-----------------------
--------------------------------------------------------------------------------------------------------------------------------------------------------------------------y----
------------------------------------------------------------------------------------------------------------------------------------------------------------------------#SS----
-----------------------------------------------------Q--?------------------------------------------------------------------oo---------------ggg------------------------##------
---------------QQ---##--#-------------------------Q---------S----------------------##---------------------?---------------o--o--------##########---#------------------###------
-------------------###--##--------------------------------------------------------###------tt---------TT------------------------------#--------#---#-----------------####------
------------------####--###------------------------------------------------------#####-----tt---------TT------------------------------#--------#---##---------------#####------
-----------------#####--####-------------------------------K-----k------ggg-----######-----tt---------TT------------------------------#--------#---##--gg----k--y--######------
XXXXXXXXXXXXXXXXXXXXXX--XXXXXXXXXXXXXXXXX-XXXXXXXXXXXXXXXXXXXXXXXXXXXXXXXXXXXXXXXXXXXXXXXXXXXXXXXXXXXXXXXXXXXXXXX--XXXXXXXXXXXXXXXXXXXX--------X---XXXXXXXXXXXXXXXXXXXXXX--XXXX
XXXXXXXXXXXXXXXXXXXXXX--XXXXXXXXXXXXXXXXX-XXXXXXXXXXXXXXXXXXXXXXXXXXXXXXXXXXXXXXXXXXXXXXXXXXXXXXXXXXXXXXXXXXXXXXX--XXXXXXXXXXXXXXXXXXXX--------X---XXXXXXXXXXXXXXXXXXXXXX--XXXX