------------------------------------------------------------------------------------------------------------------------------------------------------------------------------------
------------------------------------------------------------------------------------------------------------------------------------------------------------------------------------
------------------------------------------------------------------------------------------------------------------------------------------------------------------------------------
------SSSSSSSSSSSSSSSSSSSSSSSSS--SSSS-----SSS---------------------------------------------------------------------------------------------------------------------------------------
---------------------------SS-------------------------------------------------------------------------------------------------------------------------------------------------------
---------------------------SS----------------------------------------k------------------------------k-------------------------------------------------------------------------------
--------------oooo-------SS------SUS--------------------------------##-----------------------------SQS--SQS----------SSSSSS!--------------------------y------------------C----------
-------------------------SS----------------------------------------###------------oooo--------------------------------------------------------------#SSS----------------------------
------------S-SSSS-U-----SS----S------SSS------------#-----------k####-----------------------------------------------------------------oo----------##-------------------------------
------------SoS--SoS-----SS--------------------k-----#-----------#####----------------------------------------------------------------------------###1--------------o---------------
------------SSS--SSS-----SSSS----SSSS--------CSSS----#----------######-----------------------------SQS--S?S--------SCSSSSSSS----------------------###-------------------SS----------
---------------------------SS-----------------K-----##---------#######-------------tt------------------------------------------#----------------#-###--SSS-------TT-----------------
------#--------------------SS-----------------------##--------########-------------tt------------------------------------------#---------------##-###------------TT-----------------
------#--------kk-------------------------------K---##-------#########--------#----tt----k---ggg--------ggg--------K-----------#------------------###---------y--TT------k-----X----
XXXXXXXXXXXXXXXXXXXXXXXXXXXXXXX--XXXX------XXXXXXXXXXX---XXXXXXXXXXXXXXXXXXXXXXXXXXXXXXXXXXXXXXXXXXXXXXXXXXXXXXXXXXXXXXXXXXXX--XXXXXX---XXXXXXXXXXXXXXXX---XXXXXXXXXXXXXXXXXXXXXXXXX
XXXXXXXXXXXXXXXXXXXXXXXXXXXXXXX--XXXX------XXXXXXXXXXX---XXXXXXXXXXXXXXXXXXXXXXXXXXXXXXXXXXXXXXXXXXXXXXXXXXXXXXXXXXXXXXXXXXXX--XXXXXX---XXXXXXXXXXXXXXXX---XXXXXXXXXXXXXXXXXXXXXXXXX