------------------------------------------------------------------------------------------------------------------------------------------------------------------------------------------------------------------------------------------------------------------------
------------------------------------------------------------------------------------------------------------------------------------------------------------------------------------------------------------------------------------------------------------------------
------------------------------------------------------------------------------------------------------------------------------------------------------------------------------------------------------------------------------------------------------------------------
------------------------------------------------------------------------------------------------------------------------------------------------------------------------------------------------------------------------------------------------------------------------
------------------------------------------------------------------------------------------------------------------------------------------------------------------------------------------------------------------------------------------------------------------------
---------------------------------------ooo-------------------------------------------------------------------------------r----------------------------------------------------------------------------------------------------------------------------------------------
-----------------------------------------------SSSSS@----------!-----------------------------------------------------SSSSS---@------------------------------------------------------------------------------------------------------------SS----S!!S--------------------
-------oooo------------oooo---------------------------------------------------------------------------------------------------------------------------------------------------S--------------------------------------y---oooo-------------------------------------------
-----------------------------------B-------------------------------------------------------------------------------------------------------------------------------------------------------------------------------#SS--------------------------------------------------
-----------------------------------b-----------ooo----------------------------------------------------------------------------------------------------------------------------------------------------------------##----------------------------------------------------
--------------------TT-----------####----------SSSSSS--------S@S!S---------------------tt----------------------SSS-----------@-----------------------------------------------------------------------------------###-----------------------------SS------#--#-----------
--------------------TT----------##---------------------------------------------tt------tt-----------------------------------------------------------------------------------------------------------------------####------tt----------------------------##--##----------
--------------------TT---------###-----------------------------------tt--------tt------tt----------------@@--------------------#----------------------------------------------#--------------------------------#####------tt---------------------------###--###---------
---------y------y---TT--------####-------k----------------K---g------tt--------tt-g----tt-----g-g---ggg----------------gg-----k#------------K------------------k-------ggg----#-------k-----kkk-------kk---y--######------tt----k---ggg-----gg-g-g----####--####--------
XXXXXXXXXXXXXXXXXXXXXXXXXXXXXXXXXXXXXXXXXXXX---XXXXXXXXXXXXXXXXXXXXXXXXXXXXXXXXXXXXXXXXXXXXXXXXXXXXXXXXXXXXX-------XXXXXXXXXXXXX--XXXXXXXXXXXXXXXXXXXXXXXXXXXXXXXXXXXXXXXXX--XXX--XXXXXXXXXXXXXXXXXXXXXXXXXXXXXXXXXX--XXXXXXXXXXXXXXXXXXXXXXXXXXXXXXXXXXXXXXXXXXXXXXXXXX
XXXXXXXXXXXXXXXXXXXXXXXXXXXXXXXXXXXXXXXXXXXX---XXXXXXXXXXXXXXXXXXXXXXXXXXXXXXXXXXXXXXXXXXXXXXXXXXXXXXXXXXXXX-------XXXXXXXXXXXXX--XXXXXXXXXXXXXXXXXXXXXXXXXXXXXXXXXXXXXXXXX--XXX--XXXXXXXXXXXXXXXXXXXXXXXXXXXXXXXXXX--XXXXXXXXXXXXXXXXXXXXXXXXXXXXXXXXXXXXXXXXXXXXXXXXXX