---------------------------------------------------------------------------------------------------------------------------------------------------------------------------------------------------
---------------------------------------------------------------------------------------------------------------------------------------------------------------------------------------------------
---------------------------------------------------------------------------------------------------------------------------------------------------------------------------------------------------
-------------------------------------SSSSSSSSSSSSSS------------------------------------------------------------------------------------------------------------------------------------------------
-------------------------------------SSSSSSSS------------------------------------------------------------------------------------------------------------------------------------------------------
-------------------------------------SSSCSSSS-------------------------------oo---------------------------------------------------------------------------------------------------------------------
-------------------------------------SSSSSSSS--QQ--------------------------@SS---------------SSSSSS!----------------1---------------------------------------------------------------##-------------
---------------------------------------------------------------------------------------------------------------------------------oooo-----------------------------------------------##-------------
-----------------------------------------------------------##-----------------------------------------------------------------------------------------------------------------------##-------------
----------------------------------------ggg------------g--###------------------SSS-------------------------------------------------------------------------------------------K---#--##-------------
--------------------------#----------SSSSSSSS--QQ------#--###-------!!!!!-2----------------QQSSSSSSS--------------QQQQ----------------------tt---##--#--------------------------##--##-------------
--------------------------#----------SSSSSSSS--------g##--###------------------------------------------#-----------------------#------------tt--###--##------------------------###--##-------------
-------------------------K#----------SSSSSSSS--------###--###------------------------------------------#-----------------------#------------tt-####--###---------*------------####-----------------
-----------ggg------------#----------SSSSSSSS-------####--###------------------oo----------------------#-----------yy----------#---------y--tt#####--####--------*-----K-----#####------------#----
XXXXXXXXXXXXXXXXXXXXXXXXXXXXXXXXXXXXXXXXXXXXXXXXXXXXXXXX--XXXXXXXXXXXXXXXXXXXXXXXXXXXXXXXXXXXXXXXXXXX--XXXXXXXXXXXXXXXXXXXXXXXXXXXXXXXXXXXXXXXXXXXX--XXXXXXXXXXXXXXXXXXXXXXXXXXXXXXXXXXXXXXXXXXXXXX
XXXXXXXXXXXXXXXXXXXXXXXXXXXXXXXXXXXXXXXXXXXXXXXXXXXXXXXX--XXXXXXXXXXXXXXXXXXXXXXXXXXXXXXXXXXXXXXXXXXX--XXXXXXXXXXXXXXXXXXXXXXXXXXXXXXXXXXXXXXXXXXXX--XXXXXXXXXXXXXXXXXXXXXXXXXXXXXXXXXXXXXXXXXXXXXX