-----------------------
-----------------------
-----------------------
-----------------------
-----------------------
-----------oo----------
-----------SSSS--------
-----------------------
-----------------------
-----------------------
-------@---------------
-----------------------
--K---------tt---------
-----K------tt--------#
XXXXXXXXX---XX--XXXXXXX
XXXXXXXXX---XX--XXXXXXX