----------------------
----------------------
----------------------
----------------------
----------------------
-----------oo---------
-----------SSSS-------
----------------------
----------------------
----------------------
-------@--------------
----------------------
--K---------tt--------
-----K------tt--------
XXXXXXXXX---XX--XXXXXX
XXXXXXXXX---XX--XXXXXX