---------------------------
---------------------------
---------------------------
---------------------------
---------------------------
-----------------------r---
-------------------SSSSS---
---------------------------
---------------------------
---------------------------
-------------SSS-----------
---------------------------
-------@@------------------
--ggg----------------gg----
XXXXXXXXXX-------XXXXXXXXXX
XXXXXXXXXX-------XXXXXXXXXX