--------------------
--------------------
--------------------
--------------------
--------------------
--------------------
--------------------
--------------------
--------------------
--------------------
-----##-------------
----###------tt-----
---#####-----tt-----
--######-----tt-----
XXXXXXXXXXXXXXXXXXXX
XXXXXXXXXXXXXXXXXXXX