-----------------------------
-----------------------------
-----------------------------
-----------------------------
-----------------------------
-----------------------------
---------------------------SS
-----------------------------
-----------------------------
S----------------------------
---------------------------SS
-----------------------------
----------------B-------tt---
---------------Kb-------tt---
X----XXXXXXXXXXXXXXXXXXXXXXXX
X----XXXXXXXXXXXXXXXXXXXXXXXX