---------------------------------
---------------------------------
---------------------------------
---------------------------------
---------------------------------
------------ooo------------------
--------------------SSSSS@-------
---------------------------------
--------B------------------------
--------b-----------ooo----------
------####----------SSSSSS-------
-----##--------------------------
----###--------------------------
---####-------k----------------K-
XXXXXXXXXXXXXXXXX---XXXXXXXXXXXXX
XXXXXXXXXXXXXXXXX---XXXXXXXXXXXXX