-----------------
-----------------
-----------------
-----------------
-----------------
-----------------
-------##--------
------###--------
------###--------
---K#-###--------
---##-###--------
---##-###--------
-#-##-###--------
##-##-###--------
XX-XX-XXXXXXXXXXX
XX-XX-XXXXXXXXXXX