----------------
----------------
----------------
----------------
----------------
----------------
SSSSSS!---------
----------------
----------------
----------------
SSSSSSS---------
----------#-----
----------#-----
----------#-----
XXXXXXXX--XXXXXX
XXXXXXXX--XXXXXX