--------------------------------
--------------------------------
--------------------------------
--------------------------------
--------------------------------
--------------------------------
-----------------y--------------
---------------#SSS-------------
--oo----------##----------------
-------------###1--------------o
-------------###----------------
-----------#-###--SSS-------TT--
----------##-###------------TT--
-------------###---------y--TT--
---XXXXXXXXXXXXXXXX---XXXXXXXXXX
---XXXXXXXXXXXXXXXX---XXXXXXXXXX