--------------------------
--------------------------
--------------------------
--------------------------
--------------------------
--------------------------
--------------------------
--------------------------
--------------------------
-------------------------y
---------------ooo-------#
------------------------##
-----------------------###
----y-y---------------####
XXXXXXXXXX--XXXXXXXXXXXXXX
XXXXXXXXXX--XXXXXXXXXXXXXX