-----------------------
-----------------------
-----------------------
-----------------------
-----------------------
-----------------------
------------##---------
------------##---------
---------y--##---------
---------#--##---------
--------##--##---------
------y###--##---------
------####--##---------
-----#####--##---------
---XXXXXXX--XXXXXXXXXXX
---XXXXXXX--XXXXXXXXXXX