------------
------------
------------
------------
------------
------------
------------
-----------y
---------#SS
--------##--
-------###--
------####--
-----#####--
-y--######--
XXXXXXXXXX--
XXXXXXXXXX--