---------------------------------
---------------------------------
---------------------------------
---------------------------------
---------------------------------
---------------------------------
------------------y--------------
----------------#SSS-------------
---oo----------##----------------
--------------###1--------------o
#-------------###----------------
#-----------#-###--SSS-------TT--
#----------##-###------------TT--
#-------------###---------y--TT--
X---XXXXXXXXXXXXXXXX---XXXXXXXXXX
X---XXXXXXXXXXXXXXXX---XXXXXXXXXX