------------
------------
------------
------------
------------
------------
------------
------------
------------
------------
Q-----------
------------
----------y-
---------###
XXX--XXXXXXX
XXX--XXXXXXX