---------------------------
---------------------------
---------------------------
---------------------------
---------------------------
---------------------------
---------------------------
---------------------------
---------------------------
-------------------------y-
---------------ooo-------##
------------------------###
-----------------------####
----y-y---------------#####
XXXXXXXXXX--XXXXXXXXXXXXXXX
XXXXXXXXXX--XXXXXXXXXXXXXXX