-----------
-----------
-----------
-----------
-----------
-----------
-----------
-----------
-----------
-----------
---------QQ
-----------
-----------
-----------
XXXXXXXXXXX
XXXXXXXXXXX