----------------------------------
----------------------------------
----------------------------------
----------------------------------
----------------------------------
----------------------------------
-------2--------------------------
----------------------------------
--------------------y-------------
oo------------------#SS-?Q--------
-------2-----------##-------------
------------------###-------------
-----------------####-------y-----
-----y--y-------#####---SSSSS-----
XXXXXXXXXXXXXXXXXXXXX-------XX-XXX
XXXXXXXXXXXXXXXXXXXXX-------XX-XXX