------------------
------------------
------------------
------------------
------------------
------------------
-------US---------
------------------
------------------
------------------
------###---SSC---
-y-####-----------
#####-------------
###---------------
XX------XX--XXXXXX
XX------XX--XXXXXX