--------------
--------------
--------------
--------------
--------------
--------------
--------------
y-------------
S-------------
--------------
-SC-----------
--------------
--SSS---------
--------------
-----XXXXXXXXX
-----XXXXXXXXX