---------------------------------------------------------------------------------------------------------------------------------------------------------------------------------------------------------
---------------------------------------------------------------------------------------------------------------------------------------------------------------------------------------------------------
---------------------------------------------------------------------------------------------------------------------------------------------------------------------------------------------------------
---------------------------------------------------------------------------------------------------------------------------------------------------------------------------------------------------------
---------------------------------------------------------------------------------------------------------------------------------------------------------------------------------------------------------
--------------------------------------------------------------------------------------------------------------------------------------------------------k--------------------------------------k---------
----------------------------------------------------------------------------------2-------@SS------------------SS2SSS@SSS--------SS2------------------S!S--S!S--------------------------------##---------
--------------------------------------------------------------------------------------------------------------------------------------------------------------------------------------------k###---------
--------------------------------------------------------------------------------------------------------------------------------------------g#----------------------------k----#------------####---------
-------------------!--@------------------------------------------------------------ggg-------------------------------------------SSS-------g##---------------------------------#-----------#####---------
----------------!---------SSS---------tt---------------------S--------------#SSSSSSSS#--#--------------tt------SSSSSSSSSSS-----------------###--------S!S--S@S--------S@SSS----#----------######---------
--------------------------------tt----tt-----------------tt----------------##--------#--#--------------tt---------------------------------####--------------------------------##---------#######---------
----------------------------K---tt----tt-----------------tt--------tt-----###--------#--##-------------tt--------------------------------#####--------------------------K-----##--------########---------
-------------------------K------tt---gtt--------------gggtt------k-tt----####--------#--##----gg-----k-tt-------------------------------######-------k----ggg--------K-----K--##-------#########---------
XXXXXXXXXXXXXXXXXXXXXXXXXXXXXXXXXXXXXXXXXXXXX---XXXXXXXXXXXXXXXXXXXXXXXXXXXXX--------X--XXXXXXXXXXXXXXXXXXXXXXXXXXXXXXXXXXXXXXXX----XXXXXXXXXX--XXXXXXXXXXXXXXXXXXXXXXXXXXXXXXXXX---XXXXXXXXXXXXXXXXXXXXX
XXXXXXXXXXXXXXXXXXXXXXXXXXXXXXXXXXXXXXXXXXXXX---XXXXXXXXXXXXXXXXXXXXXXXXXXXXX--------X--XXXXXXXXXXXXXXXXXXXXXXXXXXXXXXXXXXXXXXXX----XXXXXXXXXX--XXXXXXXXXXXXXXXXXXXXXXXXXXXXXXXXX---XXXXXXXXXXXXXXXXXXXXX