-------------------------------------------------------------------------------------------------------------------------------------------------------------------------------------------------------------------------
-------------------------------------------------------------------------------------------------------------------------------------------------------------------------------------------------------------------------
-------------------------------------------------------------------------------------------------------------------------------------------------------------------------------------------------------------------------
-------------------------------------------------------------------------------------------------------------------------------------------------------------------------------------------------------------------------
-------------------------------------------------------------------------------------------------------------------------------------------------------------------------------------------------------------------------
------------------------K------------------------------------------------------------------------------------------------------------------------------------------------------------------------------------------------
-----------------------y##-----------------SUSSSSSSSSSSSSSSSSSSSSSSSSSSSSSSS----------------------------------------------------------------------------------------------------------------------------------##---------
-----------------------###------------------------------------------------------------------------------------------------------------------------------------------------------------------------------------##---------
----------------------####----------------------------------------------------------------------------------------------------------------------------------------------------------------g----------------K--##---------
----------------------####---------------------------------------------------------------------------------------------B------------------------------------------------------------------#----------------#--##---------
--------------------#-####---!!!!--------------------------------------------SS--------------------SU---------SS------S#C-----------------------------------tt-----------------K--------g##----------------#--##---------
------------------K##-####-------------------------------------------------------------------B-------------------------------B------------------------------tt--------------------------###----B---------#-#--##---------
------------------###-####-----------------------------------------------------------B-------b-----------B-------------------b-----tt---------tt------------tt-----tt----------B-------####----b--------##-#--##--------F
-----------------####-####-------------------------------K--------K--K---------------b------KB-K---------b-----g---B-----g-g-b-----tt------K--tt------------tt-----tt-----K-K--b------#####--g-B-------###-#--##--------#
XXXXXXXXXXXXXXX-XXXXX-XXXXXXXXXXXXXX-XXXXXXXX-XXXX-X-XXX-XXXXXX-XXXXXXXXXXXXXX--XXXX-XXXXXXXXXXXXXXXXXXXXXXXXXXXXXXXXXXXXXXXXXXXXXXXXXXXXX-XXXXX-X-X------XXXXXXXXXXXXXXXXXXXX-X---XXXXXXXXXXXXX-XXXXXXXXX-X--XX-XXXXXXXX
XXXXXXXXXXXXXXX-XXXXX-XXXXXXXXXXXXXX-XXXXXXXX-XXXX-X-XXX-XXXXXX-XXXXXXXXXXXXXX--XXXX-XXXXXXXXXXXXXXXXXXXXXXXXXXXXXXXXXXXXXXXXXXXXXXXXXXXXX-XXXXX-X-X------XXXXXXXXXXXXXXXXXXXX-X---XXXXXXXXXXXXX-XXXXXXXXX-X--XX-XXXXXXXX