----------------------------------------------------------------------------------------------------------------------------------------------------
----------------------------------------------------------------------------------------------------------------------------------------------------
----------------------------------------------------------------------------------------------------------------------------------------------------
-------------------------------------------@--------------------------ooo---------------------------------------------------------------------------
------------------------------------R--------------------o------------SSS---------------------------------------------------------------------------
--------------------ooo---------SSS---------------------------SSS-------------r-------------------------o-------------------------------------------
-------------------SSSSS---------------SSSSS----SSS-----------------------SSSSS-SSS--------SSS--------SSS-------------------------------SSS---------
----------------------------------------------------------SSS------ooo-----------------------------------------------SSS----------------------------
----------------------------r-------------------o------------------SSS--------------------------o---------------------------------------------------
------------------------ooooor---------------------SSS-SSS---------------o---------------------------------------ooooo------------------------------
-----------------------SSSSSSS--------------SSS-------------------------SSS---------SSS-SSS-----SSS---------SSS--SSSSS------------------------------
---------------------------------------r-----------------------------------------------------------------SSS----------------------SSSSS-------------
--------------------------------------ooo----------------------------------------------------------SSS----------------------------------------------
------------------------------------SSSSSSS------------------------r-------------------------------------------------------------------------------S
XXXXXXXXXXXXXXX-SSSSS-------------------------------------------SSSSS----------------------------------------------------SSSSSSS-------------XXXXXXX
XXXXXXXXXXXXXXX------------------------------------------------------------------------------------------------------------------------------XXXXXXX