------------------------------------------------------------------------------------------------------------------------------------------------------------------------------------
------------------------------------------------------------------------------------------------------------------------------------------------------------------------------------
------------------------------------------------------------------------------------------------------------------------------------------------------------------------------------
-------------------------------------------------------------------------------------------------------------------------------------------------------@----------------------------
-------------------------------------------------------------------------------------------------------------------------------------------------------------------------g----------
------------------------------------------------------------------------------------------------------------------------------------------------------------------------------------
---------------------------@SS----------------------------------------------------SSSSSSS----2----------------------------------------SSSSS------------------------------##---------
---------------------------------------------------------------------------------------------------------------------------------------------------------SS-------------###---------
----------------------------------------------------------------B---------------------------------------------------------------------------------------------#--------####---------
-----------------------------------------------------------------------------------------------------------------------------------------------------SS------##-------#####---------
---------------------------------------!!!!-------------------SS#@S---------------SSSSSSS---------------------------------------------SSSSS-----------------###------######---------
----------------------------B-----------------B---------B-------------------tt---------------tt--------------tt------------------------------#----B--------####-----#######---------
-------------------B----------------B-------------------------------B-------tt---------------tt---------B----tt----tt-----B-----tt-----------#------------#####----########---------
--------------------------K-B---------------K--------K-----------K----------tt---------------tt--------------tt---ktt-----------tt-----------#----B------######---#########--------S
XXXXXXXXXXXXXXXXXXXXXXXXXXXXXXXXXXXXXXXXXXXXXXXXXXXXXXXXXXXXXXXXXXXXXXXXX--XXXX--XXXXXXXXXXXXXXXXXXXXXXXXXXXXXXXXXXXXXXXXXXXXXXXXXXXXXXXXXXXXXXXXXXXXXXX-XXXXXXXXXXXXXXXXXXXXXXXXXXX
XXXXXXXXXXXXXXXXXXXXXXXXXXXXXXXXXXXXXXXXXXXXXXXXXXXXXXXXXXXXXXXXXXXXXXXXX--XXXX--XXXXXXXXXXXXXXXXXXXXXXXXXXXXXXXXXXXXXXXXXXXXXXXXXXXXXXXXXXXXXXXXXXXXXXX-XXXXXXXXXXXXXXXXXXXXXXXXXXX