---------------------------------------------------------------------------------------------------------------------------------------------------------
---------------------------------------------------------------------------------------------------------------------------------------------------------
---------------------------------------------------------------------------------------------------------------------------------------------------------
-------------------------------------oo------------------------------------------------------------------------------------------------------------------
--------------------------------------------g-g----------------------------------------------------------------------------------------------------------
---------------------------ooor---------SSSSSSS-------------oooo----------R-----g------------oo--oo------------------------------------------------------
--------------------------SSSSS-----------------------------SSSS---------------------oo---------------------------R-----oo--------------------##---------
--------------------------------------------------oo---SSSS-----------------SSSSSS----------------------------r--------------------SSS--------##---------
--------------------------------------------------------------------------------------------------------SSSSSSSS----------------------------####---------
-----------------------------------SSS------------------------------------------------SSS---------------------------------------------------####---------
------------------------SSSSSSSS--------------------------------------SSS---------------------SSS-------------------SSSS--SSSS------------######---------
-----------------------------------------------------------@------------------------------------------------------------------------------######---------
---------------------------------o----------------------------------------------------------------SSSS------------------------------------######---------
------------------SSSS----------SSS------------------------------------------------------------------------------ooo-----------------rr---######--------S
XXXXXXXXXXXXXXXX----------------------------------SSSS-----SSSSS-SSSSS-------------------------------------------SSS-------------XXXXXXXXXXXXXXXXXXXXXXXX
XXXXXXXXXXXXXXXX-----------------------------------------------------------------------------------------------------------------XXXXXXXXXXXXXXXXXXXXXXXX