-------------------------------------------------------------------------------------------------------------------------------------------------------------------------------------------
-------------------------------------------------------------------------------------------------------------------------------------------------------------------------------------------
-------------------------------------------------------------------------------------------------------------------------------------------------------------------------------------------
-------------------------------------------------------------------------------------------------------------------------------------------------------------------------------------------
-------------------------------------------------------------------------------------------------------------------------------------------------------------------------------------------
-------------------------------------------------------------------------------------------------------------------------------------------------------------------------------------------
------------------------------------@S---------------------------------------------------------------------------!--------------------------------------------------------------##---------
-----------------------------------------------------------------------------------------#SSS-----------------------------------------------------------------------------------##---------
----------------------------------------------------------------------------oo----------##----------------------------------------------------------#SS-------------------------##---------
---------------------------------------------------------------------------------------###2--------------ooo------------------#SS-@!---------------##------------------------#--##---------
----------------!!-----------------###---SS@------------------ooo-------##-------------###-----------------------!-----------##-------------------###--S@-------------------##--##---------
--------------------------------####-----------------------------------###-----------#-###--SSS-------tt--------------------###------------------####----------------------###--##---------
-----------------------------#####------------------------------------####----------##-###------------tt-------------------####-----------------#####---SSS---------------####--##---------
--------------------------######-------------------------------------#####-------------###------------tt------------------#####---SSSSS--------######--------------------#####--##--------S
XXXXXXXXXXXXXXXXXXXX--XXXXXXXXX------XX--XXXXXXXXXXXXXXXX--XXXXXXXXXXXXXXX---XXXXXXXXXXXXXXXX---XXXXXXXXXXXXXXXXXXXXXXXXXXXXXXX-------XX-XXXXXXXXXXXX------XXXXXXXXX---XXXXXXX--XXXXXXXXXXX
XXXXXXXXXXXXXXXXXXXX--XXXXXXXXX------XX--XXXXXXXXXXXXXXXX--XXXXXXXXXXXXXXX---XXXXXXXXXXXXXXXX---XXXXXXXXXXXXXXXXXXXXXXXXXXXXXXX-------XX-XXXXXXXXXXXX------XXXXXXXXX---XXXXXXX--XXXXXXXXXXX