-------------------------------------------------------------------------------------------------------------------------------------------------------------------------------------------------------------------------
-------------------------------------------------------------------------------------------------------------------------------------------------------------------------------------------------------------------------
-------------------------------------------------------------------------------------------------------------------------------------------------------------------------------------------------------------------------
-------------------------------------------------------------------------------------------------------------------------------------------------------------------------------------------------------------------------
-------------------------------------------------------------------------------------------------------------------------------------------------------------------------------------------------------------------------
------------------------------------------------------------------------------------------------------------------------g-------------------------------------------------------------------------------------K----------
-----------------------SS@S-----------------------------------------SSSSS-----SSSS@---------------------------------S---SSSSSSSSS------------@S---SS-------------SSS-------------------------------------------##---------
--------------------------------tt-----------------------------------------------------------------------------tt------------------------------------------------------tt------------------------------------###---------
--------------------------------tt----------------------------tt-----------------------tt----------------------tt------------------------------------------------------tt-----------------------------------####---------
--------------------------------##----------------------tt----tt-----------------------tt----------------------tt-------------------------SS---------------------------tt----------------------------------#####---------
----------SSS------tt---!---tt----------------tt---S@---tt----##------------------!----tt-------------tt------S##-------------------------------SSS---------#---SSS----##-----tt-------tt----------------tt#####---------
-------------------tt-------tt----------------tt--------tt----------------------tt-----tt-----tt------tt-----------------------------------------------#-tt-#-----------------tt-----tttt----tt----------tt#####---------
-------------------tt-------tt-----tttt-------tt--------tt---------tt-----tt----tt--tt-tt-----tt------tt-tt--------tt--------------tt--tt-------------##-tt-##----------------tt---tttttt----tt---------#tt#####---------
-------------------tt-----k-tt-----tttt----K--tt------g-tt---------tt-----tt----tt--tt-tt---g-tt------tt-tt--------tt--------------tt--tt------------###-tt-##-----g-----gg---tt---tttttt----tt--------##tt#####--------S
XXXXXXXXXXXXXXXXXXXXXXXXXXXXXXXXXXXXXXXXXXXXXXXXXXXXXXXXXXXXXXXXXXXXXXXXXXXXXXXXXXXXXXXXXXXXXXXXXXXXXXXXXXXXXXXXXXXXXXXXXXX------XXXXXXXXXXXX-X-XXXXXXXX-XXXXXXXXXXXXXXXXXXXXXXXXXXXXXXXXXXXXXXXXXXXXXXXXXXXXXXXXXXXXXXXX
XXXXXXXXXXXXXXXXXXXXXXXXXXXXXXXXXXXXXXXXXXXXXXXXXXXXXXXXXXXXXXXXXXXXXXXXXXXXXXXXXXXXXXXXXXXXXXXXXXXXXXXXXXXXXXXXXXXXXXXXXXX------XXXXXXXXXXXX-X-XXXXXXXX-XXXXXXXXXXXXXXXXXXXXXXXXXXXXXXXXXXXXXXXXXXXXXXXXXXXXXXXXXXXXXXXX