-----------------------------------------------------------------------------------------------------------------------------------------------------------------------------------------------------------------------------------------------------------------------------------------------------------------------------------------------------------------------------------------
-----------------------------------------------------------------------------------------------------------------------------------------------------------------------------------------------------------------------------------------------------------------------------------------------------------------------------------------------------------------------------------------
-----------------------------------------------------------------------------------------------------------------------------------------------------------------------------------------------------------------------------------------------------------------------------------------------------------------------------------------------------------------------------------------
-----------------------------------------------------------------------------------------------------------------------------------------------------------------------------------------------------------------------------------------------------------------------------------------------------------------------------------------------------------------------------------------
-----------------------------------------------------------------------------------------------------------------------------------------------------------------------------------------------------------------------------------------------------------------------------------------------------------------------------------------------------------------------------------------
-------------------------------------------------------------------------------------------------------------oo--------------------------------------------------------------------------------------------------------------------------------------------------------------------------------------------------------------------------------------------------------------------------
----------------------------------------------------------------------------------------------------------------------------------------------------------SSSS@SSS------------------------------------------------------------------------------------------------------------------------------------------------------------------------------------------------------------##---------
------------------------------------------------------------------------------------------------------------------------------------------------------------------------------------------------------------------------------------------------------------------------------------------------------------------------------------------------------------------------------##---------
----------------------------------------------------------------------------------------------------------------------------------------------------------------------------------------------------------------------------------------------------------------------------------------#-----------------------------------------------------------------------------------#-##---------
----------------------------------------------------------------o---------------2--------o--------o-------------------------------------------------------------------------------------SS@SSSSS-------------------------------oo---------------------tt-------------------------------##--oo------o----o-------------------oo---oo-----------------------------------------#-##---------
-----------------------------------tt---------------------------------------tt----------------tt--------tt-----------------------------------------------#----2----#------------------------------------------------------------------------------tt--tt------------------------------###---------------------------------------------------------------------------------#-#-##---------
-----------------------------------tt---------------------------------------tt----tt----------tt--------tt----------------------------------tt-----------#---------#--------------------------------------------------------------------------tt--tt--tt-----------------------------####---------------------------------------------------------------tt----------------#-#-##---------
-----------------------------------tt---------------------------------------tt----tt----------tt--------tt---------tt-----------------------tt-----------#---------#----------------------------------------------#---------------------------tt--tt--tt----------------------------#####----------------------#---#------------------------------------tt---------tt---#-#-#-##---------
------------------g----ggg----ggg--tt------kk----------------k-------ggg----tt---gtt----------tt--------tt--ggg----tt--k----kkk---kkk-------tt------ggg--#-------K-#--------K----K-----------------------------kk-#---------------------ggg---tt--tt--tt------g--ggg----ggg-----gg-######--g-------------------#-k-#------------------------k------kkk--tt---------tt---#-#-#-##--------S
XXXXXXXXXXXXXXXXXXXXXXXXXXXXXXXXXXXXXXXXXXXXXX-X-XX-XX-XX-XXXXXXXXXXXXXXXXXXXXXXXXXXXXXXXXXXXXXXXXXXXXXXXXXXXXXXXXXXXXXXXXXXXXXXXXXXXXXXXXXXXXXXXXXXXXXXXXXXXXXXXXXXXXXXX-X-XX-X-XX-XXXXXXXXXXXXXXXXX-X-X-XXXXXXXXXXXXXXXXXXX------XXXXXXXXXX-XX--XX--XXXXXXXXXXXXXXXXXXXXXXXXXXXXXXXXXXXXXXXXXXXX---XX---XXXXXXXXXXXXXXXX-----X----XXXXXXXXXXXXXXXXXXXXXXXXXXXXXXXXXXX-X-X-X-XXXXXXXXXXX
XXXXXXXXXXXXXXXXXXXXXXXXXXXXXXXXXXXXXXXXXXXXXX-X-XX-XX-XX-XXXXXXXXXXXXXXXXXXXXXXXXXXXXXXXXXXXXXXXXXXXXXXXXXXXXXXXXXXXXXXXXXXXXXXXXXXXXXXXXXXXXXXXXXXXXXXXXXXXXXXXXXXXXXXX-X-XX-X-XX-XXXXXXXXXXXXXXXXX-X-X-XXXXXXXXXXXXXXXXXXX------XXXXXXXXXX-XX--XX--XXXXXXXXXXXXXXXXXXXXXXXXXXXXXXXXXXXXXXXXXXXX---XX---XXXXXXXXXXXXXXXX-----X----XXXXXXXXXXXXXXXXXXXXXXXXXXXXXXXXXXX-X-X-X-XXXXXXXXXXX