-------------------------------------------------------------------------------------------------------------------------------------------------------------------------------------------------------
-------------------------------------------------------------------------------------------------------------------------------------------------------------------------------------------------------
-------------------------------------------------------------------------------------------------------------------------------------------------------------------------------------------------------
-------------------------------------------------------------------------------------------------------------------------------------------------------------------------------------------------------
-------------------------------------------------------------------------------------------------------------------------------------------------------------------------------------------------------
--------------------------------------------------------------------------------g-g--------------------------------------------------------------------------------------------------------------------
----------------------!---------------------------------------------------------SSSSSSSS---SSS!--------------@-----------SSS----S!!S--------------------------------------------------------#----------
-------------------------------------------------------------------------------------------------------------------------------------------------------------------------------------------##----------
------------------------------------------------------------------------------------------------------------------------------------------------------------------------------------------###----------
-----------------------------------------------------------------------------------------------------------------------------------------------------------------------------------------####----------
----------------!---S@S!S---------------------tt---------tt------------------S@S--------------@-----S!----!--!--!---S------------SS------#--#----------##--#-----------SS!S-------------#####----------
-------------------------------------tt-------tt---------tt-----------------------------------------------------------------------------##--##--------###--##--------------------------######----------
----------------------------tt-------tt-------tt---------tt----------------------------------------------------------------------------###--###------####--###-----tt--------------tt-#######----------
----------------------g-----tt-------ttg------tt---gg----tt--------------------------------------gg--------k------gg--------gg--gg----####--####----#####--####----tt---------gg---tt########----------
XXXXXXXXXXXXXXXXXXXXXXXXXXXXXXXXXXXXXXXXXXXXXXXXXXXXXXXXXXXXXXXXXXXXX--XXXXXXXXXXXXXXX---XXXXXXXXXXXXXXXXXXXXXXXXXXXXXXXXXXXXXXXXXXXXXXXXXXXXXXXXXXXXXXXX--XXXXXXXXXXXXXXXXXXXXXXXXXXXXXXXXXXXXXXXXXXXX
XXXXXXXXXXXXXXXXXXXXXXXXXXXXXXXXXXXXXXXXXXXXXXXXXXXXXXXXXXXXXXXXXXXXX--XXXXXXXXXXXXXXX---XXXXXXXXXXXXXXXXXXXXXXXXXXXXXXXXXXXXXXXXXXXXXXXXXXXXXXXXXXXXXXXX--XXXXXXXXXXXXXXXXXXXXXXXXXXXXXXXXXXXXXXXXXXXX