----------------------------------------------------------------------------------------------------------------------------------------------------------------------
----------------------------------------------------------------------------------------------------------------------------------------------------------------------
-----------------------------------------------------------------------------------------------------------------------------------------------------------SSS--------
-----SSSSSSSSSSSSSSSSSSSSSSSSSSSSSSSSSSSSSSSSSSS-SSSSSSSSSSSSSSSSSSSSSSSSSSSSSSSSSSSSSSSSSSSSSSSSSSSSSSSSSSSSSSSSSSSSSSSSSSSSSSSSSSSSSSSSS----------------------------
------------------------------------------------------SS--SSSSSS--SSSS-----SSSSS--------------------------------------------------------------------------------------
------------------------------------------------------SS--SSSSSS--SSSS--g--SSSSS--------------------------------------------------------------------------------------
-----------------------------------------oooo-------SS--------SS---S---SS----------oooooo-----------------------------------------------------------------------------
----------------------------------------------------SS--------SS---S---SS----------SSSSSS-----------------------------------------------------------------------------
---------------------------------------S-SSSS-S-----SS--------SS---S---SS----------SSSSSS---------------------------------------------------SSS-----------------------
-----------------------------!S---------SoS--SoS-----SS----ooooSS---SoS-SS--gg----------------------------------------------------------gg--------SSSSS@--------------
----------!@!!!--------#-#-------------SSS--SSS-----SSSS--SSSSSS---SSS-SS--SSSSS-----------------------------tt-------------------------##-----------------SSS--------
---------------------#-#-#-#---#----------------------SS-----------------------------------------------tt----tt-----------SS-----------###----------------------SSSSSS
-----------------g-#-#-#-#-#---#-#--------------------SS-----------------------------------------------tt----tt----tt-----SS----------####----------------------SSSSSS
----------------g#-#-#-#-#-#-g-#-#-----------kk-------------k-g-g-----------------------------------gggtt----tt--g-tt-----SS---------#####--------r-------------SSSSSS
XXXXXXXXXXXXXXXXXXXXXXXXXXXXXXXXXXXXXXXXXXXXXXXXXXXXXXXXXXXXXXXXXXXXX--XXXXXXXXX--XXXXXXXXXXXXXXXXXXXXXXXXXXXXXXXXXXXXXX--XX--XXXXXXXXXXXX--SSS--XXXXXXXX-------XXXXXX
XXXXXXXXXXXXXXXXXXXXXXXXXXXXXXXXXXXXXXXXXXXXXXXXXXXXXXXXXXXXXXXXXXXXX--XXXXXXXXX--XXXXXXXXXXXXXXXXXXXXXXXXXXXXXXXXXXXXXX--XX--XXXXXXXXXXXX-------XXXXXXXX-------XXXXXX