---------------------------------------------------------------------------------------------------------------------------------------------------------------------------------------------------------
---------------------------------------------------------------------------------------------------------------------------------------------------------------------------------------------------------
---------------------------------------------------------------------------------------------------------------------------------------------------------------------------------------------------------
---------------------------------------------------------------------------------------------------------------------------------------------------------------------------------------------------------
----------------------------------------------------------------------------------------------------------------------------------------------------------------------------------------------##---------
----------------------------------------------------------------------------------------------------------------------------------------------------------------------------------------------##---------
-----------------------------SSS---------------------!!!!!-----------@SSS--------SS2SS------SSSS-----------------------------@SSS-----------------------------------SSSSS--@--------------2---##---------
------------------------g---------------------------------------------------------------------------------------------------------------------------------------------------------------------##---------
----------------------------------------------------------------------------------------------------------------------------------------------------------------------------------------------##---------
------------------------#------------------------------------------------------------------------------g--------------------------tt----------------------------------------------------------##---------
---------------S@S-----##---------#-----------tt-----@!!!!----------S-----tt---!!!!--!!!---------------tt-----------------tt------tt-----------------------------@--------!--------------SS---##---------
----------------------###---------#-----------tt--------------------------tt---------------------------tt-----------g-----tt--tt--tt----------------------#---------------------tt------------##---------
---------------------####---------##----------tt--------------------------tt---------------------------tt----------tt-----tt--tt--tt----------------------#---------------------tt------------##---------
--------------------#####-------kk##-------gg-tt------------gg----#-ggg---tt------------ggg------------tt----------tt---g-tt--tt--tt-----k-------------K--#-------gg-----K-K----tt-------k----##--------S
XXXXXXXXXXXXXXXXXXXXXXXXXXXXXXXXXXXXXXXXXXXXXXXXXXXXXXXXXXXXXXXXXXXXXXXXXXXXXXXXXXXXXXXXXXXX----XXXXXXXXXX---XXXXXXXXXXXXXXXXXXXXXXXXXXXXXX---XXXXXXXXXX--XXXXXXXXXXXXXXXXXXXXXXXXXXXXXXXXXXXXXXXXXXXXXXX
XXXXXXXXXXXXXXXXXXXXXXXXXXXXXXXXXXXXXXXXXXXXXXXXXXXXXXXXXXXXXXXXXXXXXXXXXXXXXXXXXXXXXXXXXXXX----XXXXXXXXXX---XXXXXXXXXXXXXXXXXXXXXXXXXXXXXX---XXXXXXXXXX--XXXXXXXXXXXXXXXXXXXXXXXXXXXXXXXXXXXXXXXXXXXXXXX