---------------------------------------------------------------------------------------------------------------------------------------------------------
---------------------------------------------------------------------------------------------------------------------------------------------------------
---------------------------------------------------------------------------------------------------------------------------------------------------------
-------------------------------------oo------------------------------------------------------------------------------------------------------------------
--------------------------------------------g-g----------------------------------------------------------------------------------------------------------
---------------------------ooor---------SSSSSSS-------------oooo----------R-----g------------oo--oo------------------------------------------------------
--------------------------SSSSS------------------------------SSS---------------------oo---------------------------R-----oo--------------------SS---------
--------------------------------------------------oo---SS-------------------SSSSSS----------------------------r--------------------SS---------SS---------
--------------------------------------------------------------------------------------------------------SSSSSSSS----------------------------SSSS---------
-----------------------------------SSSSS----------------------------------------------SS----------------------------------------------------SSSS---------
------------------------SSSSSSSS--------------------------------------SSS---------------------SS--------------------SSSS--SSSS------------SSSSSS---------
-----------------------------------------------------------@------------------------------------------------------------------------------SSSSSS---------
---------------------------------o----------------------------------------------------------------SSSS------------------------------------SSSSSS---------
------------------SSSS----------SSS------------------------------------------------------------------------------ooo-----------------r----SSSSSS--------S
XXXXXXXXXXXXXXXX----------------------------------SSSS-----SSSSS-SSSSS-------------------------------------------SSS-------------XXXXXXXXXXXXXXXXXXXXXXXX
XXXXXXXXXXXXXXXX-----------------------------------------------------------------------------------------------------------------XXXXXXXXXXXXXXXXXXXXXXXX