-------------------------------------------------------------------------------------------------------------------------------------------------------------------------------------------------------------------------
-------------------------------------------------------------------------------------------------------------------------------------------------------------------------------------------------------------------------
-------------------------------------------------------------------------------------------------------------------------------------------------------------------------------------------------------------------------
-------------------------------------------------------------------------------------------------------------------------------------------------------------------------------------------------------------------------
-------------------------------------------------------------------------------------------------------------------------------------------------------------------------------------------------------------------------
------------------------K------------------------------------------------------------------------------------------------------------------------------------------------------------------------------------------------
------------------------##------------------@SSSSSSSSSSSSSSSSSSSSSSSSSSSSS------------------------------------------------------------------------------------------------------------------------------------##---------
-----------------------###------------------------------------------------------------------------------------------------------------------------------------------------------------------------------------##---------
----------------------####----------------------------------------------------------------------------------------------------------------------------------------------------------------e----------------K--##---------
----------------------####---------------------------------------------------------------------------------------------B------------------------------------------------------------------#----------------#--##---------
--------------------#-####---!!!!--------------------------------------------SS--------------------S@---------SS------S#@-----------------------------------tt--------------------------e##----------------#--##---------
------------------K##-####-------------------------------------------------------------------B-------------------------------B------------------------------tt--------------------------###----B---------#-#--##---------
------------------###-####-----------------------------------------------------------B-------------------B-------------------------tt---------tt------------tt-----tt------------------####-------------##-#--##---------
-----------------####-####-------------------------------K--------K--K----------------------KB-K---------------g---B-----g-g-------tt------K--tt------------tt-----tt-----K-K---------#####--g-B-------###-#--##--------S
XXXXXXXXXXXXXXX-XXXXX-XXXXXXXXXXXXXX-XXXXXXXX-XXXX-X-XXX-XXXXXX-XXXXXXXXXXXXXX--XXXX-XXXXXXXXXXXXXXXXXXXXXXXXXXXXXXXXXXXXXXXXXXXXXXXXXXXXX-XXXXX-X-X------XXXXXXXXXXXXXXXXXXXX-X---XXXXXXXXXXXXX-XXXXXXXXX-X--XX-XXXXXXXX
XXXXXXXXXXXXXXX-XXXXX-XXXXXXXXXXXXXX-XXXXXXXX-XXXX-X-XXX-XXXXXX-XXXXXXXXXXXXXX--XXXX-XXXXXXXXXXXXXXXXXXXXXXXXXXXXXXXXXXXXXXXXXXXXXXXXXXXXX-XXXXX-X-X------XXXXXXXXXXXXXXXXXXXX-X---XXXXXXXXXXXXX-XXXXXXXXX-X--XX-XXXXXXXX