------------------------------------------------------------------------------------------------------------------------------------------------------------------------
------------------------------------------------------------------------------------------------------------------------------------------------------------------------
------------------------------------------------------------------------------------------------------------------------------------------------------------------------
----------------------------oo-------------------------------------------------------ooo--------------------------------------------------------------------------------
-------------------------------------------------------@-----------------------------SSS------------------------------------------------------------------oo------------
--------------------------------------------ooooooo---------------------------------------------------------------------------------------------------------------------
--------------------------------------------SS-------------------------SSoo----SS----------------------------------------SS-----oo--SSS---------------------SSS---------
-------------------------------------------------------SS----------------------------------------------------------------------SS----------------SS---------------------
------------------------------------------------SS-------------------------------------------------------------------------------------------SS--oo------SS-------------
------------------------------------------------------------------------------------------SSS-------oooo---------------------------------------------SS-----------------
---------------------SSS-------SSSS------------------------------SSSSS-----SS-----SS-----------------------SSSSS------------------SS---SSSS-----------------------------
-------------------------------------------------------------------------------------SSSSS------------------------------------------------------------------------------
-------------------------------------------------SSSS-------------------------------------------------------------------------------------------------------------------
------------------------------------------------------------SS---------------------------------------------------------------------------------------------------------S
XXXXXXXXXXXXXXXX--SSS---SSS-SS-------SSS---SSS-----------------------------------------------SSS-SSSS--SSS-------SSSSS-----SSS------SSSS------------------------XXXXXXXX
XXXXXXXXXXXXXXXX------------------------------------------------------------------------------------------------------------------------------------------------XXXXXXXX