----------------------------------------------------------------------------------------------------------------------------------------------------------------------------------------------------------------------------------
----------------------------------------------------------------------------------------------------------------------------------------------------------------------------------------------------------------------------------
----------------------------------------------------------------------------------------------------------------------------------------------------------------------------------------------------------------------------------
----------------------------------------------------------------------------------------------------------------------------------------------------------------------------------------------------------------------------------
----------------------------------------------------------------------------------------------------------------------------------------------------------------------------------------------------------------------------------
-------------------------------------------------------------------------oo-------------------------------------------------------------------------------------------------------------------------------------------------------
------------------------------------oooo---------------o-o-o------------o--o---------------------ooo--@-----ooo----------------------oooooo----------------------------------------------------------------------------##---------
--------------------------------------------------------o-o------------------------------------------------------------------------------------------------------------------oooooo-----------------------------------###---------
--------------------------------------------------------------------------------------------------------------------------------------------K------------------------------------------------------------------------####---------
-----------------------------------------------------------------------------------------------------------------------------------------------------oooo-----------------------------------------------------------#####---------
---------------------------------------k------------K--------------------------r---------------r---#SSSSS#---------------------------------------------------------------------------------------------------------######---------
------------###SSSSSSSSSSSSSSSS#SSSSSSSSSSSSSSS#SSSSSSSSSSSSSSS#----#SSSSSSSSSS#----#SSSSSSSSSS#---#-----#----------------SSS--#SSSSSSSSSSSSSSS#------------K--#SSSSSSSS#--SS--SS--SS--#SSSSSSSSS##---------------#######---------
-----------####----------------#---------------#---------------#----#----------#----#----------#---#-----#---------------------#---------------#---------------#--------#--------------#---------###-------------########---------
----------#####----------------#---------------#---------------#----#----------#----#----------#---#-----#-------------r-------#---------------#--#SSSSSSSS#---#--------#--------------#---------####-----------#########--------S
XXXXXXX-SSSSSSSS---------------#---------------#---------------#----#----------#----#----------#---#-----#------SSSSSSSS-------#---------------#--#--------#---#--------#--------------#--------SSSSSSSSSSSSS--XXXXXXXXXXXXXXXXXXX
XXXXXXX------------------------#---------------#---------------#----#----------#----#----------#---#-----#---------------------#---------------#--#--------#---#--------#--------------#-----------------------XXXXXXXXXXXXXXXXXXX