----------------------------------------------------------------------------------------------------------------------------------------------------------------------------------------------------------------------------------
----------------------------------------------------------------------------------------------------------------------------------------------------------------------------------------------------------------------------------
----------------------------------------------------------------------------------------------------------------------------------------------------------------------------------------------------------------------------------
----------------------------------------------------------------------------------------------------------------------------------------------------------------------------------------------------------------------------------
----------------------------------------------------------------------------------------------------------------------------------------------------------------------------------------------------------------------------------
-------------------------------------------------------------------------oo-------------------------------------------------------------------------------------------------------------------------------------------------------
------------------------------------oooo---------------o-o-o------------o--o---------------------ooo--@-----ooo--------------------------------------------------------------------------------------------------------##---------
--------------------------------------------------------o-o------------------------------------------------------------------------------------------------------------------oooooo-----------------------------------###---------
---------------------------------------------------------------------------------------------------------------------------------------------------------------------------------------------------------------------####---------
-----------------------------------------------------------------------------------------------------------------------------------------------------oooo-----------------------------------------------------------#####---------
---------------------------------------k------------K--------------------------r---------------r---#SSSSS#---------------------------------------------------K-----------------------------------------------------######---------
------------###SSSSSSSSSSSSSSSS#SSSSSSSSSSSSSSS#SSSSSSSSSSSSSSS#----#SSSSSSSSSS#----#SSSSSSSSSS#---#-----#---------------------#----------SSS--#---------------#SSSSSSSS#--SS--SS--SS--#SSSSSSSSS##---------------#######---------
-----------####----------------#---------------#---------------#----#----------#----#----------#---#-----#---------------------#---------------#---------------#--------#--------------#---------###-------------########---------
----------#####----------------#---------------#---------------#----#----------#----#----------#---#-----#-------------r-------#-------r-------#--#SSSSSSSSS#--#--------#--------------#---------####-----------#########--------S
XXXXXXX-SSSSSSSS---------------#---------------#---------------#----#----------#----#----------#---#-----#------SSSSSSSS-------#SSSSSSSS-------#--#---------#--#--------#--------------#--------SSSSSSSSSSSSS--XXXXXXXXXXXXXXXXXXX
XXXXXXX------------------------#---------------#---------------#----#----------#----#----------#---#-----#---------------------#---------------#--#---------#--#--------#--------------#-----------------------XXXXXXXXXXXXXXXXXXX