--------------------------------------------------------------------------------------------------------------------------------------------------------
--------------------------------------------------------------------------------------------------------------------------------------------------------
--------------------------------------------------------------------------------------------------------------------------------------------------------
--------------------------------------------------------oo----------------------------------------------------------------------------------------------
-------------------------------------------------@-----SSSS-------------------o-------------------------------------------------------------------------
------------------------------SSS--------------------------------------------SSS-------------------------oo---------------------------------------------
---------------------------------------------------------------------------------o------o-o-----SSS-----SSSS------R---------------------SSS-------------
---------------------------g---------o----ooo-------K-------SSS---o---o---o------SSS-------------------------o----------------------SSS-----------------
----------------------SSSSSS-------------------SSSSSS------------SSS-SSS-SSS------------SSS-----------------SSS-----------------------------------------
---------------------------------SSS--------------------------------------------------------------------------------------------------------SSS---------
-------------------------------------------SSSS-----ooo---------------------------------------SSSSSS------------------------K-K-------------------------
------------------SSSSS-------------------------------K-----------------------------------------------------o----------SSSSSSSSSSSS---------------------
----------------------------------------------SSSSSSSSSS----------------------------SSSS---------------SSS-SSSSS----------------------------------------
-------------------------------oo---SSSSSSS------------------------------K-----------------------------------------------------------------------------S
XXXXXXXXXXXXXXXX--------------SSS--------------------------------SSSSSSSSSSSSSSSS-----------------------------------SSS-------------------------XXXXXXXX
XXXXXXXXXXXXXXXX--------------------------------------------------------------------------------------------------------------------------------XXXXXXXX