-------------------------------------------------------------------------------------------------------------------------------------------------------------------------------------------
-------------------------------------------------------------------------------------------------------------------------------------------------------------------------------------------
-------------------------------------------------------------------------------------------------------------------------------------------------------------------------------------------
S-----SSSSSSSSSSSSSSSSSSSSSSSSSSSSSSSSSSSSSSSSSSSSSSSSSSS----------SSSSSSSSSSSSSSSSSSSSSSSSSSSSSSSSSSSSSSSSSSSSS-------SSSS-SSS-----SSSSSSSSSSSSSSSSSSSSSSS-----SSSSSSSSSSSSSSSSSSSSSSSSSSS
S-------------------SSSSSSSSSSSSSSSSSSSSSSSSSSSS----------------------------------------------------------------------------------------------------------------SSSSSSSSSSSSSSSS-----------
S-------------------SSSSSSSSSSSSSSSSSSSSSSS@SSSS----------------------------------------------------------------------------------------------------------------SSSSSSSSSSSSSSSS-----------
S-------------------SSSSSSSSSSSSSSSSSSSSSSSSSSSS--!!-------SSS--2SS------------------------------------------------SSS-S@S----------------------------------SSS-SSSSSSSSSSSSSSSS-----------
S-----------------------------------------------------------------------------tt--------------------------------------------------------------------------------S-------------------tt-----
S---------------------------------------------------------------!-------------tt--------------------------------------------------------------------------------S-------------------tt-----
S------------------------------------------ggg-----------------!-!------------tt-------S--------------------------------------------------------------------------oooooooooo--------tt-----
S---------------------SSSSSSS-SSSSSSSSSSSSSSSSSS--!!--!@!---------!---------S@ttS@-------------------------tt----------SSSS-SSS---------------tt----------g------@SSSSSSSSSS----#---tt-----
S---------------------SSSSS---SSSSSSSSSSSSSSSSSS------------------------tt----tt----tt---tt-------------#--tt--##-------------------------tt--tt----------#--------------------##---tt-----
S---------------------SSSSS---SSSSSSSSSSSSSSSSSS------------------------tt----tt----tt---tt------------##--tt--##------------------tt-----tt--tt---------##-------------------###---tt-----
S--------------------------oooSSSSSSSSSSSSSSSSSS------------------------tt---ktt---gtt--gtt---------kk-##--tt--##--SSS-------------tt----ktt--tt--------###-SSS---------kk---####--gtt-----
XXXXXXXXXXX--XX--X---XXXXXXXXXXXXXXXXXXXXXXXXXXXXXXXXXXXX------XXXXXXXXXXXXXXXXXXXXXXXXXXXXXXXXXXXXXXXXXX--XX--XX------XXXXXXXXXXXXXXXXXXXXXXXXX--XXXXXXXXX-----XXXXXXXXXXXXXXXXXXXXXXX--XX
XXXXXXXXXXX--XX--X---XXXXXXXXXXXXXXXXXXXXXXXXXXXXXXXXXXXX------XXXXXXXXXXXXXXXXXXXXXXXXXXXXXXXXXXXXXXXXXX--XX--XX------XXXXXXXXXXXXXXXXXXXXXXXXX--XXXXXXXXX-----XXXXXXXXXXXXXXXXXXXXXXX--XX