----------------------------------------------------------------------------------------------------------------------------------------------------------------------------------------------------------------------------------
----------------------------------------------------------------------------------------------------------------------------------------------------------------------------------------------------------------------------------
----------------------------------------------------------------------------------------------------------------------------------------------------------------------------------------------------------------------------------
----------------------------------------------------------------------------------------------------------------------------------------------------------------------------------------------------------------------------------
----------------------------------------------------------------------------------------------------------------------------------------------------------------------------------------------------------------------------------
----------------------------------------------------------------------------------------------------------------------------------------------------------------------------------------------------------------------------------
-------------------------!--------------------------------------!-!-------------------------2-------------------------------------------------------!!!!---------------------------------------------------------------##---------
---------------------------------------------------------------------------------------------------------oooo----------oooo------------oooo---------------------------------------------------------------------------###---------
---------------------------------------------------------------------------------------------------------------------------------------------------------------------------------------------------------------------####---------
------------------------------------------oo------------------------------------------------------------------------------------------------------------------------------------------------------------------------#####---------
-------------------------@---------------o--o-------------------!-!-----------------------!!!!----------------------tt--------------tt------------!!@SS!!!---------------------------------------------------------######---@-----
---------------------tt--------------------------------------------------------------------------------#------------tt--------------tt-------------------------------------------------------#--------------------#######---------
---------------------tt--------------------------------------------------------------------------------#------------tt--------------tt---------------------------tt--------------------------#-------------------########---------
---------------------tt--------------------------------------------------------------------------------#------------tt--------------tt---------------------------tt--------------------------#------------------#########--------S
XXXXXXXXXXXXXXXXXXXXXXXXXXXXXXXX--XXXXXXXXXXXXXXXXXXXXXXXXXXXXXXXXXXXXXXXXXXXX----XXXXXXXXXXXXXXXXXXXXXXXXXXXXXXXXXXXXXXXXXXXXXXXXXXXXXXXXXXXXXXXXXXX--XXXXXXXXXXXXXXXXXXXXXXX---XXX--XXXXXXXX--XXXXXXXXXXXXXXXXXXXXXXXXXXXXXXXXXX
XXXXXXXXXXXXXXXXXXXXXXXXXXXXXXXX--XXXXXXXXXXXXXXXXXXXXXXXXXXXXXXXXXXXXXXXXXXXX----XXXXXXXXXXXXXXXXXXXXXXXXXXXXXXXXXXXXXXXXXXXXXXXXXXXXXXXXXXXXXXXXXXX--XXXXXXXXXXXXXXXXXXXXXXX---XXX--XXXXXXXX--XXXXXXXXXXXXXXXXXXXXXXXXXXXXXXXXXX