--------------------------------------------------------------------------------------------------------------------------------------------------------------------------------------------------------------
--------------------------------------------------------------------------------------------------------------------------------------------------------------------------------------------------------------
--------------------------------------------------------------------------------------------------------------------------------------------------------------------------------------------------------------
--------------------------------------------------------------------------------------------------------------------------------------------------------------------------------------------------------------
--------------------------------------------------------------------------------------------------------------------------------------------------------------------------------------------------------------
--------------------------------------------------------------------------------------------------------------------------------------------------------------------------------------------------------------
------------------------------------------------------------------------------------------S@S------------------------------------------------------------------------------------------------##---------------
---------------------------------------------------------------------------------------------------------------------------------------------------------------------------------------------##---------------
------------------------------------------------------------------------------------------------------------------------------------------------------------tt-------------------------------##---------------
------------------------------------------------------------------------------------------------------------------------------------------------------------tt------------------------K---#--##---------------
-----------------------------------------------------------------------------------------#####-----------------------------------------------------#2SS-----##---------------------------##--##---------------
--------------------------------------------tt-----tt------------------------------------#--------------------------#------------------------------#------------------------------------###--##---------------
--------------------------------------------tt-----tt------------------------------------#---------------------B----#------------------------------#-----------B---tt-----B------------####-------------------
----------------k--ggg--------ggg--------kk-tt-----tt--------k---ggg--------ggg--------K-#-------------ggg----------#----ggg---k-------ggg------kk-#---------------tt-------------K---#####------------------S
XXXXXXXXXXXXXXXXXXXXXXXXXXXXXXXXXXXXXXXXXXXXXXXXX--XXXXXXXXXXXXXXXXXXXXXXXXXXXXXXXXXXXXXXXXX----XXXXXXXXXXXXXXXXXX--XXXXXXXXXXXXXXXXXXXXXXXXXXXXXXXXXXXX---XXXXXXXXXXXXXXXXXXXXXXXXXXXXXXXXXXXXXXXXXXXXXXXXXXX
XXXXXXXXXXXXXXXXXXXXXXXXXXXXXXXXXXXXXXXXXXXXXXXXX--XXXXXXXXXXXXXXXXXXXXXXXXXXXXXXXXXXXXXXXXX----XXXXXXXXXXXXXXXXXX--XXXXXXXXXXXXXXXXXXXXXXXXXXXXXXXXXXXX---XXXXXXXXXXXXXXXXXXXXXXXXXXXXXXXXXXXXXXXXXXXXXXXXXXX