---------------------------------------------------------------------------------------------------------------------------------------------------------------------------------------------------------
---------------------------------------------------------------------------------------------------------------------------------------------------------------------------------------------------------
---------------------------------------------------------------------------------------------------------------------------------------------------------------------------------------------------------
---------------------------------------------------------------------------------------------------------------------------------------------------------------------------------------------------------
---------------------------------------------------------------------------------------------------------------------------------------------------------------------------------------------------------
---------------------ooo--------------------------------------------------------------oo---------------------------------------------------------------------r--------------oo---------------------------
-----------------------------SSSSS@--------------------------------------------------@SS------------------------------SSSSSSS!---------------------------SSSSS--------------SSSS--------------##---------
---------------------------------------------------------------------------------------------------------------------------------------------------------------------------------------------###---------
-----------------B---------------------------------------------------##----------------------------------------------------------------------------------------------------------------------###---------
-----------------------------ooo---------------------------------g--###------------------SSS----------------------------------------------------------------------------------------------K#-###---------
---------------####----------SSSSSS------------##----------------#--###-------!!!!!-2---------------------------------SSSSSSSS---------------------SSS------------------@-----------------##-###---------
---------------#------------------------------###------tt------g##--###----------------------------------------------------------#--------------------------------------------------------##-###---------
--------------##-----------------------------#####-----tt------###--###------------------------------------B-------tt------------#-----------@@------------------------------tt---------#-##-###---------
-------------###-------k----------------K---######-----tt-----####--###------------------oo---------------K--------tt------------#------ggg----------------gg----------------tt--------##-##-###--------S
XXXXXXXXXXXXXXXXXXXXXXXXXX---XXXXXXXXXXXXXXXXXXXXXXXXXXXXXXXXXXXXX--XXXXXXXXXXXXXXXXXXXXXXXX----XXXXXXXXXXXXXXXXXXXXXXXXXXXXXXX--XXXXXXXXXXXXXXX-------XXXXXXXXXXXXXXXXXXX---XX--XXXXXXXX-XX-XXXXXXXXXXXX
XXXXXXXXXXXXXXXXXXXXXXXXXX---XXXXXXXXXXXXXXXXXXXXXXXXXXXXXXXXXXXXX--XXXXXXXXXXXXXXXXXXXXXXXX----XXXXXXXXXXXXXXXXXXXXXXXXXXXXXXX--XXXXXXXXXXXXXXX-------XXXXXXXXXXXXXXXXXXX---XX--XXXXXXXX-XX-XXXXXXXXXXXX