-------------------------------------------------------------------------------------------------------------------------------------------------------------------------------------------------------------------------------------------------------------------------------
-------------------------------------------------------------------------------------------------------------------------------------------------------------------------------------------------------------------------------------------------------------------------------
-------------------------------------------------------------------------------------------------------------------------------------------------------------------------------------------------------------------------------------------------------------------------------
---------------------------------------------------------------------------------------------------------------------------------------------------------------------------------------------------------------------------------------------------SSS----------SSSSSSSSSSS----
-------------------------------------------------------------------------------------------------------------------------------------------------------------------------------------------------------------------------------------------------------------------------------
-------------------------------------------------------------------------------------------------------------------------------------------------------------------------------------------------------------------------------------------------------------------------------
---------!----------------------------------SSSSSS!-------------------------------------------------SUS----------------------------------------------SUS----------------------------------------------------------------------Q-Q----------------------------CSS---------------
-------------------------------------------------------------oooo------------oooo--------------------------------------------------------------------------------------------------------------------------------y-------------------------------------------------------------
---------------------------------------------------------------------------------------------------------------------------------------------------------------------------------------------------------------#SS--------------------------------------SSS--2-----------------
--------------------------------------------------------------------------------------------Q--?--------------------------------------------------------------------------------------------------------------##--------------------------------------------2-2----------------
-------S@S!S---------------------tt---------SSSSSSS-----------------------TT-------------Q---------S####---------------------------------------------####----------------------------------------------------###--------------Q-Q------------------QQQ---------2---------SC----
-------------------------tt------tt-------------------#-------------------TT--------------------------------------------------#------------------------------------------------#----------------------------####-----------------------------------------------------TT--------
---------------tt--------tt------tt-------------------#-------------------TT---------------------------------------------*----#-------------------------------------------*----#---------------------------#####-----------------------------------------------------TT--------
--------g------tt--------tt-g----tt-----g-g-----------#--------y------y---TT----------------------K---------------ggg----*----#----ggg--k----ggg-------------------ggg----*----#----ggg--k----ggg------y--######----y-------------y----------------------------------TT---k----
XXXXXXXXXXXXXXXXXXXXXXXXXXXXXXXXXXXXXXXXXXXXXXXXXXXX--XXXXXXXXXXXXXXXXXXXXXXXXXXXXXXXXXXXXXXXXXXXXXXXX----XXXXXXXXXXXXXXXXXX--XXXXXXXXXXXXXXXXXXXXXXXXX----XXXXXXXXXXXXXXXXXX--XXXXXXXXXXXXXXXXXXXXXXXXXXXXXXXXX--XXXXXXXXXXXXXXXXXXXXXXXXXX----XXXXXX------XXXXXXXXXXXXXXXXXXX
XXXXXXXXXXXXXXXXXXXXXXXXXXXXXXXXXXXXXXXXXXXXXXXXXXXX--XXXXXXXXXXXXXXXXXXXXXXXXXXXXXXXXXXXXXXXXXXXXXXXX----XXXXXXXXXXXXXXXXXX--XXXXXXXXXXXXXXXXXXXXXXXXX----XXXXXXXXXXXXXXXXXX--XXXXXXXXXXXXXXXXXXXXXXXXXXXXXXXXX--XXXXXXXXXXXXXXXXXXXXXXXXXX----XXXXXX------XXXXXXXXXXXXXXXXXXX