---------------------------------------------------------------------------------------------------------------------------------------------------------------------------------------------------------------------------------
---------------------------------------------------------------------------------------------------------------------------------------------------------------------------------------------------------------------------------
---------------------------------------------------------------------------------------------------------------------------------------------------------------------------------------------------------------------------------
----------------------------------------------------------SSSSSS-----------------------------------------------------------------------------------------------------------------------------------------------------------------
---------------------------------------------------------------------------------------------------------------------------------------------------------------------------------------------------------------------------------
------------------ooo--------------------------------------------------------------------oo----------------------------------------------------------------------------------------------k---------------------------------------
--------------------------SSSSS@--------------------------------------------------------@SS-------!---------------------------------------------------------------------------------S---SSSSSSS--------------------------SCS-----
--------------------------------------------------------------------------------------------------------------------------------------------------------------------------------TT-----------------------------------------------
--------------B---------------------------------------------------------##------------------------------------------------------------------------------------------------------TT-----------------------------------------------
--------------b-----------ooo---------------------------------------g--###------------------SSS---------------------------------------------------------------------------------TT-----------------------------------------------
------------####----------SSSSSS----------##--#---------------------#--###-------!!!!!-2--------S@S!S---------------------tt-----------------------------#-------------tt------S##S--------------S-------------------tt---2------
-----------##----------------------------###--##------------------g##--###----------------------------------------tt------tt-----------------------------#-----TT------tt--------------------------------------#-----tt----------
----------###---------------------------####--###-----------------###--###------------------------------tt--------tt------tt----------------------------K#-----TT------tt-TT--------TT-----------------TT-----##-----tt----------
---------####-------k----------------K-#####--####---------------####--###------------------oo---g------tt--------tt-g----tt-----g-g------ggg------------#---k-TT------tt-TT--------TT---------------k-TT----###-----tt----k-----
XXXXXXXXXXXXXXXXXXXXXXX---XXXXXXXXXXXXXXXXXX--XXXXXXXXXXXXXXXXX-XXXXX--XXXXXXXXXXXXXXXXXXXXXXXXXXXXXXXXXXXXXXXXXXXXXXXXXXXXXXXXXXXXXXXXXXXXXXXXXXXXXXXXXXXXXXXXXXXXXXXXXXXXXXXXXXXXXXXXXXXXX---XXXXXXXXXXXXXXXXXXXXXXXXXXXXXXXXXX
XXXXXXXXXXXXXXXXXXXXXXX---XXXXXXXXXXXXXXXXXX--XXXXXXXXXXXXXXXXX-XXXXX--XXXXXXXXXXXXXXXXXXXXXXXXXXXXXXXXXXXXXXXXXXXXXXXXXXXXXXXXXXXXXXXXXXXXXXXXXXXXXXXXXXXXXXXXXXXXXXXXXXXXXXXXXXXXXXXXXXXXX---XXXXXXXXXXXXXXXXXXXXXXXXXXXXXXXXXX