-----------
-----------
-----------
-----------
-----------
-----------
----C------
-----------
-----------
-----------
---SS------
-----------
-----------
----k-----X
XXXXXXXXXXX
XXXXXXXXXXX