--------------
--------------
--------------
--------------
--------------
--------------
-SSSS---------
--------------
--------------
------------g-
------------tt
------------tt
------------tt
------------tt
X----XXXXXXXXX
X----XXXXXXXXX