---------------------------------------
---------------------------------------
---------------------------------------
---------------------------------------
---------------------------------------
---------------------------------------
---------------------USSS--------------
---------------------------------------
---------------------------------------
-------------------E------TT-----------
t-----------------TT------TT-----------
t----------g------TT--tt--TT-----------
t----------TT-----TT--tt--TT-----------
t----------TT--g--TT--tt--TT-----k-----
XX---XXXXXXXXXXXXXXXXXXXXXXXXXXXXXX---X
XX---XXXXXXXXXXXXXXXXXXXXXXXXXXXXXX---X