------------------
------------------
------------------
------------------
------------------
------------------
SSSSS---?---------
------------------
------------------
------------------
------Q-----------
------------TT----
------------TT----
-----K-K----TT----
XXXXXXXXXXXXXXXXXX
XXXXXXXXXXXXXXXXXX