------------------------------
------------------------------
------------------------------
------------------------------
------------------------------
------------------------------
--------USSS--------SSCSS-----
------------------------------
------------------------------
------------------------------
-------S-----TT---QQQQ--QQQ---
-------------TT---------------
-------------TT---------------
g----k-ggg---TT------------ggg
XXXXXXXXXXXXXXXXXXXXXXXXXXXXXX
XXXXXXXXXXXXXXXXXXXXXXXXXXXXXX