--------
--------
--------
--------
--------
--------
--------
--------
--------
--------
------SU
--------
--------
--------
XXXXXXXX
XXXXXXXX