----------------------------
----------------------------
----------------------------
----------------------------
----------------------------
----------------------------
-------------------QQQQQ----
----------------------------
----------------------------
---------------------k------
#-----------TT-----?QQQQ----
#-----------TT--------------
##----------TT--------------
##---gg-----TT------------gg
XXXXXXXXXXXXXXXXXXXXXXXXXXXX
XXXXXXXXXXXXXXXXXXXXXXXXXXXX