---------------------
---------------------
---------------------
---------------------
---------------------
---------------------
---------------------
---------------------
---------------------
---------------------
------------------C--
-----------#---------
-------K---#---------
-----------#-----gg--
XXXXXXXXX--XXXXXXXXXX
XXXXXXXXX--XXXXXXXXXX