------------------
------------------
------------------
------------------
------------------
------------------
-----------LSSS---
------------------
-------g----------
-------#----------
S-----##---2-----#
-----###---------#
----####---------#
---#####----kk---#
XXXXXXXXXXXXXXXXXX
XXXXXXXXXXXXXXXXXX