-------------
-------------
-------------
-------------
-------------
-------------
-SSSS--------
-------------
-------------
------------g
------------t
------------t
------------t
------------t
X----XXXXXXXX
X----XXXXXXXX