------------------
------------------
------------------
------------------
------------------
-k----------------
SQS--SQS----------
------------------
------------------
------------------
SQS--S?S--------SC
------------------
------------------
-----ggg--------K-
XXXXXXXXXXXXXXXXXX
XXXXXXXXXXXXXXXXXX