----------------------------------
----------------------------------
----------------------------------
----------------------------------
----------------------------------
------------------------k---------
-----------------------##---------
----------------------###---------
--------#-----------k####---------
--k-----#-----------#####---------
CSSS----#----------######---------
-K-----##---------#######---------
-------##--------########---------
---K---##-------#########--------#
XXXXXXXXX---XXXXXXXXXXXXXXXXXXXXXX
XXXXXXXXX---XXXXXXXXXXXXXXXXXXXXXX