-----------
-----------
-----------
-----------
-----------
-----------
-----------
-----------
-----------
-----------
-----------
---------TT
---------TT
------gggTT
XXXXXXXXXXX
XXXXXXXXXXX