----------
----------
----------
----------
----------
----------
----------
----------
----------
----------
--TT------
--TT------
--TT------
--TT------
XXXXXXXXXX
XXXXXXXXXX