-------------------------
-------------------------
-------------------------
-------------------------
-------------------------
-------------------------
------1--------USS-------
-------------------------
-------------------------
------ggg----------------
##########---#-----------
#--------#---#-----------
#--------#---##----------
#--------#---##--gg----k-
X--------X---XXXXXXXXXXXX
X--------X---XXXXXXXXXXXX