-----------------
-----------------
-----------------
-----------------
-----------------
-----------------
-----------------
-----------------
-------g#--------
------g##--------
------###--------
-----####--------
----#####--------
---######------k-
XXXXXXXXX--XXXXXX
XXXXXXXXX--XXXXXX