----------------------
----------------------
----------------------
----------------------
----------------------
----------------------
----------------------
----------------------
----------------------
----------------------
SSS---------TT--------
--K---TT----TT--------
------TT----TT--------
------TT---gTT--------
XXXXXXXXXXXXXXXXXXX---
XXXXXXXXXXXXXXXXXXX---