----------------------
----------------------
----------------------
----------------------
----------------------
----------------------
SSQSSS?SSS--------SSC-
----------------------
----------------------
--K---------------SSS-
SSSSSSSSSSS-----------
----------------------
----------------------
--------K-------------
XXXXXXXXXXXXXXXXX----X
XXXXXXXXXXXXXXXXX----X