-------------------
-------------------
-------------------
-------------------
-------------------
-------------------
-------------------
-------------------
-------------------
-----------Q--?----
--------Q---------S
-------------------
-------------------
-----------------K-
XXXXXXXXXXXXXXXXXXX
XXXXXXXXXXXXXXXXXXX