-----------------
-----------------
-----------------
-----------------
-----------------
-----------------
-----------------
-----------------
-----------------
-----------------
--S--------------
----------------#
--------TT-----##
------k-TT----###
XXXXXXXXXXXXXXXXX
XXXXXXXXXXXXXXXXX