-----------
-----------
-----------
-----------
-----------
-----------
-----------
-----------
-----------
-----------
-----------
-----------
-----------
--------kkk
XXXXXXXXXXX
XXXXXXXXXXX