--------------------
--------------------
--------------------
--------------------
--------------------
--------------------
--------------------
---oooo-------------
--------------------
--------------------
--------------------
----tt--------------
----tt--------------
----tt----k---ggg---
XXXXXXXXXXXXXXXXXXXX
XXXXXXXXXXXXXXXXXXXX