--------------------
--------------------
--------------------
--------------------
--------------------
--------------------
--------------------
--------------------
--------------------
--------------------
--------------------
--------------------
--------------------
----kkk-------kk----
XXXXXXXXXXXXXXXXXXXX
XXXXXXXXXXXXXXXXXXXX