---------------------------------------------
---------------------------------------------
---------------------------------------------
---------------------------------------------
---------------------------------------------
---------------------------------------------
---------------------------------------------
-----------------S---------------------------
---------------------------------------------
---------------------------------------------
---------------------------------------------
---------------------------------------------
-----------------#---------------------------
--k-------ggg----#-------k-----kkk-------kk--
XXXXXXXXXXXXXX--XXX--XXXXXXXXXXXXXXXXXXXXXXXX
XXXXXXXXXXXXXX--XXX--XXXXXXXXXXXXXXXXXXXXXXXX