-----------------
-----------------
-----------------
-----------------
-----------------
-----------------
-----------------
-----------------
-----------------
-----------------
-----------------
-----------------
-----------------
----k------ggg---
XXXXXXXXXXXXXXXXX
XXXXXXXXXXXXXXXXX