-------------------------
-------------------------
-------------------------
-------------------------
-------------------------
-------------------------
--------------##---------
-------------###---------
------------####---------
-----------#####---------
----------######---------
---------#######---------
--------########---------
---ggg-#########--------S
XXXXXXXXXXXXXXXXXXXXXXXXX
XXXXXXXXXXXXXXXXXXXXXXXXX