--------------------------------
--------------------------------
--------------------------------
--------------------------------
--------------------------------
--------------------------------
@-------------------------------
--------------------------------
--------------------------------
--------------------------------
@-------------------------------
--------------------------------
--#-----------------------------
-k#------------K----------------
XXX--XXXXXXXXXXXXXXXXXXXXXXXXXXX
XXX--XXXXXXXXXXXXXXXXXXXXXXXXXXX