----------------------------
----------------------------
----------------------------
----------------------------
----------------------------
----------------------------
----------------------------
-----------@----------------
----------------------------
----------------------------
------ooo-------------------
-----------#----------------
-----------#--------------#-
#----------#-----k----ggg-#-
XXXXXXXXXXXXXXXXXXXXXXXXXXXX
XXXXXXXXXXXXXXXXXXXXXXXXXXXX