---------------------------------------------------------------------------------------------------------------------------------------------------------------------------------------------
---------------------------------------------------------------------------------------------------------------------------------------------------------------------------------------------
---------------------------------------------------------------------------------------------------------------------------------------------------------------------------------------------
-------------------------------------------------------------------------------------------------------------------------------------------------------------------------------------SSSS----
---------------------------------------------------------------------------------------------------------------------------------------------------------------------------------------------
----------------------------------------------------------------------------------------oo---------------------------------------------------------------------------------------------------
------------------------------------------Q-Q------------------------------------------@SS--------------------------SS----S!!S---------------------------------------------------------------
---------------------------------------------------------------------------------------------------------------------------------------------------------------------------------------------
-----------------------------------------------------------------------##--------------------------------------------------------------------------------------------------------------------
-------------------------------------------------------------------g--###------------------SSS-----------------------------------------------------------------------------------------------
------------------------------------------Q-Q----------------------#--###-------!!!!!-2-------SSS---------TT---------------SS------#--#---------------------------#---##--#------------------
-----------TT----K-----------------------------------------------g##--###-----------------------K---TT----TT----------------------##--##--------------------------#--###--##-----------------
-----------TT----------------------------------------------------###--###---------------------------TT----TT---------------------###--###------------------------K#-####--###----------------
-----------TT-----------ggg-----y-------------y-----------------####--###------------------oo-------TT---gTT----------gg-g-g----####--####---------ggg------------######--####---------------
XXXXXXXXX--XXXXXXXXXXXXXXXXXXXXXXXXXXXXXXXXXXXXXXXXXXXXX----XXXXXXXX--XXXXXXXXXXXXXXXXXXXXXXXXXXXXXXXXXXXXXXXXXXX---XXXXXXXXXXXXXXXXXXXXXXXXXXXXXXXXXXXXXXXXXXXXXXXXXXXX--XXXXXXXXXXXXXXXXXXX
XXXXXXXXX--XXXXXXXXXXXXXXXXXXXXXXXXXXXXXXXXXXXXXXXXXXXXX----XXXXXXXX--XXXXXXXXXXXXXXXXXXXXXXXXXXXXXXXXXXXXXXXXXXX---XXXXXXXXXXXXXXXXXXXXXXXXXXXXXXXXXXXXXXXXXXXXXXXXXXXX--XXXXXXXXXXXXXXXXXXX