-----------------------------------------------------------------------------------------------------------------------------------------------------------------------------------------------------------------------
-----------------------------------------------------------------------------------------------------------------------------------------------------------------------------------------------------------------------
-----------------------------------------------------------------------------------------------------------------------------------------------------------------------------------------------------------------------
-----------------------------------------------------------------------------------SSSSSSSSSSSSSSSSSSSSSSSSSSSSSS---------------------------------------------------------SSSSSSSSSSSSSSSSSSSSSSSSSSSSSSSSSSSSSSS------
-----------------------------------------------------------------------------------------------------------------------------------------------------------------------------------------------------------------------
-----------------------------------------------------------------------------oo----------------------------------------------------------------------------------------------------------------------------------------
---------------------SSSSSS!------------------------------------------------@SS---------------------------------------SSS---------------------------------SSSSSS!------------------------------------------------------
-----------------------------------------------------------------------------------------------------------------------------------------------------------------------------------------------------------------------
------------------------------------------------------------##------------------------------------------------------SS-------------------------------------------------------------------------------------------------
--------------------------------------------------------g--###------------------SSS-----S----------------------------------SSSSSSU----------------Q--?-----------------------------------------------------------------
-------------tt---SU-SSSSSSS----------------tt---SU-----#--###-------!!!!!-2--------------------------------TT---------------------------------Q---------SSSSSSSS-------------------tt------------------------g##------
----------K--tt----------------#---------K--tt--------g##--###-----------------------TT---tt-------------#--TT--##--------------------------------------------------#---------TT----tt-----------SS-----------###------
-------------tt----------------#------------tt--------###--###-----------------------TT---tt------------##--TT--##----SSS-------------------------------------------#---------TT----tt----TT-----SS---------g####------
-------------tt----------------#------------tt-------####--###------------------oo--kTT--ktt---------kk-##--TT--##-----------r--------------------------K-----------#------g--TT----tt--g-TT-----SS---------#####------
XXXXXXXXXXXXXXXXXXXXXXXXXXXXX--XXXXXXXXXXXXXXXXXXXXXXXXXX--XXXXXXXXXXXXXXXXXXXXXXXXXXXXXXXXXXXXXXXXXXXXXXX--XX--XX---------XXXXXXXX--XXXXXXXXXXXXXXXXXXXXXXXXXXXXX--XXXXXXXXXXXXXXXXXXXXXXXXXXX--XX--XXXXXXXXXXXX--XXXX
XXXXXXXXXXXXXXXXXXXXXXXXXXXXX--XXXXXXXXXXXXXXXXXXXXXXXXXX--XXXXXXXXXXXXXXXXXXXXXXXXXXXXXXXXXXXXXXXXXXXXXXX--XX--XX---------XXXXXXXX--XXXXXXXXXXXXXXXXXXXXXXXXXXXXX--XXXXXXXXXXXXXXXXXXXXXXXXXXX--XX--XXXXXXXXXXXX--XXXX