----------------------------------------------------------------------------------------------------------------------------------------------------------------------------------------------------
----------------------------------------------------------------------------------------------------------------------------------------------------------------------------------------------------
----------------------------------------------------------------------------------------------------------------------------------------------------------------------------------------------------
------SSSSSSSSSSSSSSSSSSSSSSSSS---------------------------------------------------------------------------------------------------------------------------------------------------------------------
---------------------------SS-----------------------------------------------------------------------------------------------------------------------------------------------------------------------
---------------------------SS-----------------------------------------------------------------oo----------------------------------------------------------------------------------------------------
--------------oooo-------SS-------!----------------------------------------------------------@SS----------------------------------------------------------------------y------------------C----------
-------------------------SS-----------------------------------------------------------------------------------------------------------------------------------------#SSS----------------------------
------------S-SSSS-U-----SS--------------------------------------------------##------------------------------------------------------------------------oo----------##-------------------------------
------------SoS--SoS-----SS----------------------------------------------g--###------------------SSS--------------------------------------------------------------###1--------------o---------------
------------SSS--SSS-----SSSS---S@S!S---------------------tt-------------#--###-------!!!!!-2-------------------------C-------------------------SSS---------------###-------------------SS----------
---------------------------SS---------------------tt------tt-----------g##--###--------------------------------#------------------------------------------------#-###--SSS-------TT-----------------
------#--------------------SS-----------tt--------tt------tt-----------###--###----------------------------K---#-----------------------------------------------##-###------------TT-----------------
------#--------kk----------------g------tt--------tt-g----tt-----g-g--####--###------------------oo------------#-----gg-----------k---ggg-------------------------###---------y--TT------k-----X----
XXXXXXXXXXXXXXXXXXXXXXXXXXXXXXXXXXXXXXXXXXXXXXXXXXXXXXXXXXXXXXXXXXXXXXXXXX--XXXXXXXXXXXXXXXXXXXXXXXXXXXXXXXXX--XXXXXXXXXXXXXXXXXXXXXXXXXXXXXXXXXXXXXX---XXXXXXXXXXXXXXXX---XXXXXXXXXXXXXXXXXXXXXXXXX
XXXXXXXXXXXXXXXXXXXXXXXXXXXXXXXXXXXXXXXXXXXXXXXXXXXXXXXXXXXXXXXXXXXXXXXXXX--XXXXXXXXXXXXXXXXXXXXXXXXXXXXXXXXX--XXXXXXXXXXXXXXXXXXXXXXXXXXXXXXXXXXXXXX---XXXXXXXXXXXXXXXX---XXXXXXXXXXXXXXXXXXXXXXXXX