--------------------------
--------------------------
--------------------------
--------------------------
--------------------------
--------------------------
---------------##---------
---------------##---------
------------K--##---------
------------#--##---------
------------#--##---------
B---------#-#--##---------
b--------##-#--##---------
B-------###-#--##--------#
X-XXXXXXXXX-X--XX-XXXXXXXX
X-XXXXXXXXX-X--XX-XXXXXXXX