-------------------------
-------------------------
-------------------------
-------------------------
-------------------------
-------------------------
--------------##---------
--------------##---------
-----------K--##---------
-----------#--##---------
-----------#--##---------
---------#-#--##---------
--------##-#--##---------
-------###-#--##--------#
-XXXXXXXXX-X--XX-XXXXXXXX
-XXXXXXXXX-X--XX-XXXXXXXX