--------------------------
--------------------------
--------------------------
--------------------------
--------------------------
--------------------------
--------------------------
--------------------------
--------------------------
----------B---------------
-SS------S#C--------------
----------------B---------
----------------b-----tt--
--g---B-----g-g-b-----tt--
XXXXXXXXXXXXXXXXXXXXXXXXXX
XXXXXXXXXXXXXXXXXXXXXXXXXX