--------------------------------
--------------------------------
--------------------------------
--------------------------------
--------------------------------
--------------------------------
--------------------------------
--------------------------------
--------------------------------
--------------------------------
---------------------tt---------
---------------------tt---------
-------tt------------tt-----tt--
----K--tt------------tt-----tt--
XXX-XXXXX-X-X------XXXXXXXXXXXXX
XXX-XXXXX-X-X------XXXXXXXXXXXXX