---------------------------------
---------------------------------
---------------------------------
---------------------------------
---------------------------------
---------------------------------
SSSSSSSSSSSS---------------------
---------------------------------
---------------------------------
---------------------------------
-------------SS------------------
-----------------------------B---
---------------------B-------b---
--K--K---------------b------KB-K-
XXXXXXXXXXXXXX--XXXX-XXXXXXXXXXXX
XXXXXXXXXXXXXX--XXXX-XXXXXXXXXXXX