--------------------------
--------------------------
--------------------------
--------------------------
--------------------------
--------------------------
--------------------------
--------------------------
--------------------g-----
--------------------#-----
---------K--------g##-----
------------------###----B
---------B-------####----b
----K-K--b------#####--g-B
XXXXXXXX-X---XXXXXXXXXXXXX
XXXXXXXX-X---XXXXXXXXXXXXX