---------------------
---------------------
---------------------
---------------------
---------------------
K--------------------
##-----------------SU
##-------------------
##-------------------
##-------------------
##---!!!!------------
##-------------------
##-------------------
##-------------------
XXXXXXXXXXXX-XXXXXXXX
XXXXXXXXXXXX-XXXXXXXX