------------
------------
------------
------------
------------
------------
------------
------------
------------
------------
--SU--------
------------
--------B---
--------b---
XXXXXXXXXXXX
XXXXXXXXXXXX