-------------------
-------------------
-------------------
-------------------
-------------------
-------------------
-----------------SU
-------------------
-------------------
-------------------
---!!!!------------
-------------------
-------------------
-------------------
XXXXXXXXXX-XXXXXXXX
XXXXXXXXXX-XXXXXXXX