------------
------------
------------
------------
------------
----------K-
---------y##
---------###
--------####
--------####
------#-####
----K##-####
----###-####
---####-####
X-XXXXX-XXXX
X-XXXXX-XXXX