-----------
-----------
-----------
-----------
-----------
----------K
---------y#
---------##
--------###
--------###
------#-###
----K##-###
----###-###
---####-###
X-XXXXX-XXX
X-XXXXX-XXX