-------------------
-------------------
-------------------
-------------------
-------------------
-------------------
SSSSSSSSSSSSSSSSSSS
-------------------
-------------------
-------------------
-------------------
-------------------
-------------------
------------K------
-XXXX-X-XXX-XXXXXX-
-XXXX-X-XXX-XXXXXX-