---------------------------------------------------------------------------------------------------------------------------------------------------------------------------------------------------------------------------------------------------------------------------------
---------------------------------------------------------------------------------------------------------------------------------------------------------------------------------------------------------------------------------------------------------------------------------
---------------------------------------------------------------------------------------------------------------------------------------------------------------------------------------------------------------------------------------------------------------------------------
------------------------SSSSSSS-----SSSSS----------------------------------------------------------------------------------------------------------------------------------------------------------------------------------------------------------------------------------------
------------------------------------SSSSS----------------------------------------------------------------------------------------------------------------------------------------------------------------------------------------------------------------------------------------
-------k----------------------------SSSSS----------------------------------------------------------------------------------------------------------------------------------------------------------------------------------------------------------------------------------------
------SQS--SQS----------------------SSSSS----------------------------------------SUS----------------------------------------------SUS----------------------------------------------------------##------------------QQQQ-------------------!--------------------------------------
------------------------------------S----------------------------------------------------------------------------------------------------------------------------------------------------------##--------------------------------------------------------------------------------
------------------------------------S-------------------------------------------------------------------------------------------------------------------------------------------------------y--##--------------------------------------------------------------------------------
--------------------------------------ooo--------------------------------------y------------------------------------------------------------------------------------------------------------#--##--------------------y-----------------------------------------------------------
------SQS--S?S--------SC-------------USSS----------------------------ooo-------######---------------------------------------------####-----------------------------------------------------##--##----------------QQ?SSQQQ---------------S@S!S---------------------tt-------------
------------------------------#-----------------------------------------------###--------------------------#------------------------------------------------#----------------------------y###--##---------------------------------------------------------tt------tt-------------
-----------------------------##-SSS------------------------------------------####---------------------*----#-------------------------------------------*----#----------------------------####--##---------------------------------TT------------tt--------tt------tt-------------
-----------ggg--------K-----###---------------------------y-y---------------#####--------------ggg----*----#----ggg--k----ggg-------------------ggg----*----#----ggg--k----ggg----------#####--##---------------------------------TT-----g------tt--------tt-g----tt-----g-g-----
XXXXXXXXXXXXXXXXXXXXXXXXXXXXXXX-----XXXXXXXXXXXXXXXXXXXXXXXXXXXX--XXXXXXXXXXXXXXXXX----XXXXXXXXXXXXXXXXXX--XXXXXXXXXXXXXXXXXXXXXXXXX----XXXXXXXXXXXXXXXXXX--XXXXXXXXXXXXXXXXXXXXXXX---XXXXXXX--XXXXXXXXXXXXXXXXXXXXX--XXXXXXXXXXXXXXXXXXXXXXXXXXXXXXXXXXXXXXXXXXXXXXXXXXXXXXXXXXX
XXXXXXXXXXXXXXXXXXXXXXXXXXXXXXX-----XXXXXXXXXXXXXXXXXXXXXXXXXXXX--XXXXXXXXXXXXXXXXX----XXXXXXXXXXXXXXXXXX--XXXXXXXXXXXXXXXXXXXXXXXXX----XXXXXXXXXXXXXXXXXX--XXXXXXXXXXXXXXXXXXXXXXX---XXXXXXX--XXXXXXXXXXXXXXXXXXXXX--XXXXXXXXXXXXXXXXXXXXXXXXXXXXXXXXXXXXXXXXXXXXXXXXXXXXXXXXXXX