--------------------------------------------------------------------------------------------------------------------------------------------------------------------------------------------------
--------------------------------------------------------------------------------------------------------------------------------------------------------------------------------------------------
--------------------------------------------------------------------------------------------------------------------------------------------------------------------------------------------------
--------------------------------------------------------------------------------------------------------------------------------------------------------------------------------------------------
--------------------------------------------------------------------------------------------------------------------------------------------------------------------------------------------------
-------------------------------------------------------------------------------------oo----------------------------------ooo----------------------------------------------------------------------
--------------------------------------------SSSSSS!---------------------------------@SS---------------LSSS-----------------------SSSSS@-----------------------------------------------------------
---------------------------------------------------------------------------------------------------------------------------------------------------------------------------------------------y----
--------------------------------------------------------------------##----------------------------g------------------B---------------------------------------------------------------------#SS----
----------------------------------------------------------------g--###------------------SSS-------#------------------b-----------ooo------------------------------------------------------##------
-----------##-------------------------------SSSSSSS-------------#--###-------!!!!!-2-------S-----##---2-----#------####----------SSSSSS--------------------------------------------------###------
----------###------tt---------------------------------#-------g##--###--------------------------###---------#-----##---------------------------------#----------------------------------####------
---------#####-----tt---------------------------------#-------###--###-------------------------####---------#----###---------------------------------#---------------------------------#####------
--------######-----tt--------------k---ggg------------#------####--###------------------oo----#####----kk---#---####-------k----------------K--------#----y--y---------------------y--######------
XXXXXXXXXXXXXXXXXXXXXXXXXXXXXXXXXXXXXXXXXXXXXXXXXXXX--XXXXXXXXXXX--XXXXXXXXXXXXXXXXXXXXXXXXXXXXXXXXXXXXXXXXXXXXXXXXXXXXXXXXXXX---XXXXXXXXXXXXXXXXXXXXX--XXXXXXXXXXXXXXXXXXXXXXXXXXXXXXXXXXXX--XXXX
XXXXXXXXXXXXXXXXXXXXXXXXXXXXXXXXXXXXXXXXXXXXXXXXXXXX--XXXXXXXXXXX--XXXXXXXXXXXXXXXXXXXXXXXXXXXXXXXXXXXXXXXXXXXXXXXXXXXXXXXXXXX---XXXXXXXXXXXXXXXXXXXXX--XXXXXXXXXXXXXXXXXXXXXXXXXXXXXXXXXXXX--XXXX