-------------------------------------------------------------------------------------------------------------------------------------------------------------------------------------------------------------
-------------------------------------------------------------------------------------------------------------------------------------------------------------------------------------------------------------
-------------------------------------------------------------------------------------------------------------------------------------------------------------------------------------------------------------
------------------------------------------------------------------------------------------SSSSSSSSSSSSSSSSSSSSSSSSSSSSSS-----SSSSSSS-----SSSSS---------------------------------------------------------------
-----------------------------------------------------------------------------------------------------------------------------------------SSSSS---------------------------------------------------------------
------------------------------------------------oo----------------------------------oo---------------------------------------------------SSSSS---------------------------------------------------------------
------------------------------------------------SSSS-------------------------------@SS---------------------------------------------------SSSSS--------Q------------------------------------------------------
-----------------------------------------------------------------------------------------------------------------------------------------S-------------------------------------------------------------------
-------------------------------------------------------------------##------------------------------------------------------SS------------S-------------------------------------------------------------------
---------------------------------------------------------------g--###------------------SSS-----S-------------------------------------------ooo-------------------------oo------------------------------------
--------------------------------------------@------------------#--###-------!!!!!-2--------------------------------TT---------------------USSS--------?---------------o--o-----------------QQ----------------
-------------------------------------------------------------g##--###-----------------------TT---tt-------------#--TT--##----------#--------------TT---------------------------------------------------------
---------------------------------------K---------tt----------###--###-----------------------TT---tt------------##--TT--##---------##-SSS----------TT---------------------------------------------------------
------------------------k------ggg--------K------tt---------####--###------------------oo--kTT--ktt---------kk-##--TT--##--------###--------------TT-----------------------------------------------ggg-------
XXXXXXXXXXXX---XXX--XXXXXXXXXXXXXXXXXXXXXXXXXX---XX--XXXXXXXXXXX--XXXXXXXXXXXXXXXXXXXXXXXXXXXXXXXXXXXXXXXXXXXXXXX--XX--XX----XXXXXXX-----XXXXXXXXXXXXXXXXXXXX--XXXXXXXXXXXXXXXXXXXXXXXXXXXXXXXXXXXXXXXXXXXXXX
XXXXXXXXXXXX---XXX--XXXXXXXXXXXXXXXXXXXXXXXXXX---XX--XXXXXXXXXXX--XXXXXXXXXXXXXXXXXXXXXXXXXXXXXXXXXXXXXXXXXXXXXXX--XX--XX----XXXXXXX-----XXXXXXXXXXXXXXXXXXXX--XXXXXXXXXXXXXXXXXXXXXXXXXXXXXXXXXXXXXXXXXXXXXX