----------------------------
----------------------------
----------------------------
----------------------------
----------------------------
----------------------------
----------------------------
----------------------------
----------------------------
---------------------------o
----------------------------
----------------------------
----------------------------
----k-k---------------k-----
XXXXXXXXX-X-XX-XX-XX-XXXXXXX
XXXXXXXXX-X-XX-XX-XX-XXXXXXX