---------------------------------------
---------------------------------------
---------------------------------------
---------------------------------------
---------------------------------------
---------------------------------------
CSSS-----------------------------------
---------------------------------------
---------------------------------------
--------------------------SSUSSSSS-----
2----#---------------------------------
--K--#-------K-------------------------
-----#-----------K---------------------
-----#---------------------------------
XXXXXXXXXXX-X-XX-X-XX-XXXXXXXXXXXXXXXXX
XXXXXXXXXXX-X-XX-X-XX-XXXXXXXXXXXXXXXXX