---------------------------------------
---------------------------------------
---------------------------------------
---------------------------------------
---------------------------------------
---------------------------------------
---------------------------------------
---------------------------------------
---------------------#-----------------
--------------------##--oo------o----o-
-------------------###-----------------
------------------####-----------------
-----------------#####-----------------
-----ggg------gg######--k--------------
XXXXXXXXXXXXXXXXXXXXXXXXXXXXXXX---XX---
XXXXXXXXXXXXXXXXXXXXXXXXXXXXXXX---XX---