--------------------------
--------------------------
--------------------------
--------------------------
--------------------------
--------------------------
--------------------------
--------------------------
--------------------------
------------------oo---oo-
--------------------------
--------------------------
-----#---#----------------
-----#-k-#----------------
XXXXXXXXXXXXXXXX-----X----
XXXXXXXXXXXXXXXX-----X----