-----------------------
-----------------------
-----------------------
-----------------------
-----------------------
-----------------------
-------------------SSSS
-----------------------
-----------------------
-----------------------
------------------#----
-----TT-----------#----
-----TT-----------#----
-----TT------ggg--#----
XXXXXXXXXXXXXXXXXXXXXXX
XXXXXXXXXXXXXXXXXXXXXXX