----------------
----------------
----------------
----------------
----------------
----------------
-------##-------
-------##-------
-----#-##-------
-----#-##-------
---#-#-##-------
---#-#-##-------
-#-#-#-##-------
-#-#-#-##-------
-X-X-X-XXXXXXXXX
-X-X-X-XXXXXXXXX