-----------------
-----------------
-----------------
-----------------
-----------------
-----------------
-----------------
-----------------
-----------------
-----------------
-----------------
-----------TT----
-----------TT----
-----kkk---TT----
XXXXXXXXXXXXXXXXX
XXXXXXXXXXXXXXXXX