---------
---------
---------
---------
---------
---------
---------
---------
---------
---------
---------
---------
-----TT--
-----TT--
XXXXXXXXX
XXXXXXXXX