-----------------------------
-----------------------------
-----------------------------
-----------------------------
-----------------------------
-----------------------oo----
-----------------------------
-----------------------------
-----------------------------
---o--------o----------------
--------tt--------TT---------
--------tt--------TT---------
--------tt--------TT---------
--------tt--------TT---ggg---
XXXXXXXXXXXXXXXXXXXXXXXXXXXXX
XXXXXXXXXXXXXXXXXXXXXXXXXXXXX