--------------------
--------------------
--------------------
--------------------
--------------------
--------------------
--------------------
--------------------
--------------------
--------------------
--------------------
--------------------
tt------------------
tt-k----kkk---kkk---
XXXXXXXXXXXXXXXXXXXX
XXXXXXXXXXXXXXXXXXXX