----------
----------
----------
----------
----------
----------
----------
----------
----------
----------
----------
----------
----------
-------k--
XXXXXXXXXX
XXXXXXXXXX