--------------------------------------------------------------
--------------------------------------------------------------
--------------------------------------------------------------
--------------------------------------------------------------
--------------------------------------------------------------
--------------------------------------------------------------
--------------------------------------------------------------
--------------------------------------------------------------
--------------------------------------------------------------
--------------------------oo---------------------tt-----------
---------------------------------------------TT--tt-----------
-----------------------------------------TT--TT--tt-----------
-------------#---------------------------TT--TT--tt-----------
-----------kk#----------------------ggg--TT--TT--tt-----k--ggg
-X-X-XXXXXXXXXXXXXXXXXXX------XXXXXXXXXX-XX--XX--XXXXXXXXXXXXX
-X-X-XXXXXXXXXXXXXXXXXXX------XXXXXXXXXX-XX--XX--XXXXXXXXXXXXX