----------------------
----------------------
----------------------
----------------------
----------------------
----------------------
----------------------
----------------------
----------------------
---------------1------
-----------TT---------
-----------TT----TT---
-----------TT----TT---
----ggg----TT---kTT---
XXXXXXXXXXXXXXXXXXXXXX
XXXXXXXXXXXXXXXXXXXXXX