----------------------------------------------------------------------------------------------------------------------------------------------------------------------------------------------------
----------------------------------------------------------------------------------------------------------------------------------------------------------------------------------------------------
----------------------------------------------------------------------------------------------------------------------------------------------------------------------------------------------------
------SSSSSSSSSSSSSSSSSSSSSSSSS---------------------------------------------------------------------------------------SSS----------SSSSSSSSSSS------------------------------------------------------
---------------------------SS-----------------------------------------------------------------------------------------------------------------------------------------------------------------------
---------------------------SS--------------------------------------------------------g-----------------------------------------------------------------------------------------------y--------------
--------------oooo-------SS--------------------------------------------------------SSSSSSSS---SSS!------------------------------CSS-------------------------SSSSS---?----------------##-------------
-------------------------SS-----------------------------------------------------------------------------y--------------------------------------------------------------------------y###-------------
------------S-SSSS-U-----SS---------------------TT--------------------------------g---------------------S------------------SSS--2--------------------------------------------------####-------------
------------SoS--SoS-----SS---------------------TT-----------------1-----------------------------------------------------------2-2------------------------------------------------#####-------------
------------SSS--SSS-----SSSS----------#LSS-----##----------tt------------------S@S--------------C-----S-SC-----------QQQ---------2---------SC--------------------Q--------------######---C---------
---------------------------SS----------#--------------------tt--------------------------------------------------------------------------TT------------------------------TT------#######-------------
------#--------------------SS----------#-----------*---TT---tt--------------------------------------------SSS---------------------------TT------------------------------TT-----########-------------
------#--------kk--------------------kk#-----------*---TT---tt------------------------------------g-g-----------------------------------TT---k-------------------K-K----TT----#########--------#----
XXXXXXXXXXXXXXXXXXXXXXXXXXXXXXXXXXXXXXXXXXXX---XXXXXXXXXXXXXXXXXXXXXXXXX--XXXXXXXXXXXXXXX---XXXXXXXXXXXX-----XXXXXXXXXXXX------XXXXXXXXXXXXXXXXXXXXX---XXX--XXXXXXXXXXXXXXXXXXXXXXXXXXXXXXXXXXXXXXXX
XXXXXXXXXXXXXXXXXXXXXXXXXXXXXXXXXXXXXXXXXXXX---XXXXXXXXXXXXXXXXXXXXXXXXX--XXXXXXXXXXXXXXX---XXXXXXXXXXXX-----XXXXXXXXXXXX------XXXXXXXXXXXXXXXXXXXXX---XXX--XXXXXXXXXXXXXXXXXXXXXXXXXXXXXXXXXXXXXXXX