--------------
--------------
--------------
SSSSSSSSSSSSSS
SSSSSSSS------
SSSCSSSS------
SSSSSSSS--QQ--
--------------
--------------
---ggg--------
SSSSSSSS--QQ--
SSSSSSSS------
SSSSSSSS------
SSSSSSSS------
XXXXXXXXXXXXXX
XXXXXXXXXXXXXX