-----------------------------------
-----------------------------------
-----------------------------------
SSSSSSSSSSSSSSSSSSSSSSSSSSSSSS-----
-----------------------------------
-----------------------------------
-----------------------------------
-----------------------------------
---------------------------------SS
-----S-----------------------------
-------------------------TT--------
--TT---tt-------------#--TT--##----
--TT---tt------------##--TT--##----
-kTT--ktt---------kk-##--TT--##----
XXXXXXXXXXXXXXXXXXXXXXX--XX--XX----
XXXXXXXXXXXXXXXXXXXXXXX--XX--XX----