------------------------------
------------------------------
------------------------------
SSSSSSSSSSSSSSSSSSSSSSSSSSSSSS
---------SSSSSSSSSSSSSSSSSSSSS
---------SSSSSSSSSSSSSSSSSSSSS
---------SSSSSSSSSSSSSSSSSSSSS
------------------------------
------------------------------
------------------------------
-----------SSSSSSU-SSSSSSSSSSS
-----------SSSSS---SSSSSSSSSSS
-----------SSSSS---SSSSSSSSSSS
----------------oooSSSSSSSSSSS
--XX--X---XXXXXXXXXXXXXXXXXXXX
--XX--X---XXXXXXXXXXXXXXXXXXXX