--------------
--------------
--------------
--SSSS-----SSS
--------------
--------------
--SUS---------
--------------
S------SSS----
--------------
--SSSS--------
--------------
--------------
--------------
--XXXX------XX
--XXXX------XX