----------------
----------------
----------------
SSSSSSSSSSSSSSSS
----------------
----------------
----------------
----------------
----------------
----------------
----------TT----
------TT--TT----
t-----TT--TT----
t----kTT--TT----
XXXXXXXXXXXX--XX
XXXXXXXXXXXX--XX