-----------------
-----------------
-----------------
SSSSSSSSSSSSSSSSS
-----------------
-----------------
-----------------
-----------------
-----------------
-----------------
-----------TT----
-------TT--TT----
tt-----TT--TT----
tt----kTT--TT----
XXXXXXXXXXXXX--XX
XXXXXXXXXXXXX--XX