---------------
---------------
---------------
--SSSS-----SSSS
---------------
---------------
--SUS----------
---------------
S------SSS-----
---------------
--SSSS---------
---------------
--------------t
--------------t
--XXXX------XXX
--XXXX------XXX