----------------------
----------------------
----------------------
SSSSSSSSSSSSSSSSSSSSSS
SSSSSSSSSSS-----------
SSSSSSSSSSS-----------
SSSSSSSSSSS-----------
---------------TT-----
---------------TT-----
ooooooo--------TT-----
SSSSSSS----#---TT-----
----------##---TT---SS
---------###---TT---SS
---kk---####--kTT---SS
XXXXXXXXXXXXXXXXXX--XX
XXXXXXXXXXXXXXXXXX--XX