-----------------
-----------------
-----------------
SSSSSSS-----SSSSS
------------SSSSS
------------SSSSS
------------SSSSS
------------S----
------------S----
--------------ooo
-------------USSS
------#----------
-----##-SSS------
----###----------
XXXXXXX-----XXXXX
XXXXXXX-----XXXXX