------------------------
------------------------
------------------------
SSS----------SSSSSSSSSSS
------------------------
------------------------
----------CSS-----------
------------------------
-----SSS--2-------------
---------2-2------------
QQQ---------2---------SC
------------------TT----
------------------TT----
------------------TT---k
XXX------XXXXXXXXXXXXXXX
XXX------XXXXXXXXXXXXXXX