----------
----------
----------
----SSSSSS
----------
----------
----------
----------
----------
----------
----------
----------
----------
----------
XXXXXXXXX-
XXXXXXXXX-