-----------------------
-----------------------
-----------------------
-----------------------
-----------------------
-----------------------
------------##---------
-----------------------
----------#------------
-----------------------
--------#--------------
-----------------------
---#--#----------------
---#------------------#
XXXXX-----------XXXXXXX
XXXXX-----------XXXXXXX