-----------------------
-----------------------
-----------------------
-----------------------
-----------------------
-----------------------
----------------SUSSSSS
-----------------------
-----------------------
------------------K----
----------##----SSSSSSS
----------##-----------
----------##-----------
----------##-----------
XXXXXXXXXXXXXXXXXXXXXXX
XXXXXXXXXXXXXXXXXXXXXXX