-----------------------------------------------------------------
-----------------------------------------------------------------
-----------------------------------------------------------------
-----------------------------------------------------------------
-----------------------------------------------------------------
-----------------------------------------------------------------
--------------------------------------------SSSSSSUS-------------
-----------------------------------------------------------------
-----------------------------------------------------------------
-------------------------------------------------K---------------
-------------------------------------tt-----SSSSSSSS---#---------
------------------B------------------tt----------------##--------
--B---------------b------------------tt----------------###-------
--b-----------K---b------------------tt--------K-------####------
XXXXXXXXXXXXXXXXXXXXXXXXXXXXXXXXXXXXXXXXXXXXXXXXXXXXX--XXXX--XXXX
XXXXXXXXXXXXXXXXXXXXXXXXXXXXXXXXXXXXXXXXXXXXXXXXXXXXX--XXXX--XXXX