--------------------
--------------------
--------------------
--------------------
--------------------
--------------------
--------------------
--------------------
--------------------
--------------------
--------------------
---------------#----
------B--------#----
------b------K-#----
XXXXXXXXXXXXXXXXXXXX
XXXXXXXXXXXXXXXXXXXX