-------------------------------------------
-------------------------------------------
-------------------------------------------
-------------------------------------------
-------------------------------------------
-------------------------------------------
S------------------------------------------
-------------------------------------------
-------------------------------------------
-------------------------------------------
S---tt-------------------------------------
----tt-------------------------------------
----tt-------------------------------------
----tt---------k--------K------------K-----
XX--XX--XXXXXXXXXXXXXXXXXXXXXXXXXXXXXXXXXXX
XX--XX--XXXXXXXXXXXXXXXXXXXXXXXXXXXXXXXXXXX