---------------------------------
---------------------------------
---------------------------------
---------------------------------
---------------------------------
---------------------------------
-------1-------------------------
--------------------oooo---------
---------------------------------
---------------------------------
-----QQQQ----------------------tt
------------------#------------tt
------------------#------------tt
------yy----------#---------y--tt
XXXXXXXXXXXXXXXXXXXXXXXXXXXXXXXXX
XXXXXXXXXXXXXXXXXXXXXXXXXXXXXXXXX