--------------------------------
--------------------------------
--------------------------------
--------------------------------
--------------------------------
--------------------------------
-------1------------------------
--------------------oooo--------
--------------------------------
--------------------------------
-----QQQQ----------------------t
------------------#------------t
------------------#------------t
------yy----------#---------y--t
XXXXXXXXXXXXXXXXXXXXXXXXXXXXXXXX
XXXXXXXXXXXXXXXXXXXXXXXXXXXXXXXX