--------------------------
--------------------------
--------------------------
--------------------------
--------------------------
--------------------------
--------------------------
--------------------------
--------------------------
--------------------------
--------------------------
-------#------------------
-------#------------------
-------#----y--y----------
XXXXXXXX--XXXXXXXXXXXXXXXX
XXXXXXXX--XXXXXXXXXXXXXXXX