---------------------------------
---------------------------------
---------------------------------
---------------------------------
---------------------------------
---------------------------------
------------Q-Q------------------
---------------------------------
---------------------------------
---------------------------------
------------Q-Q------------------
---------------------------------
---------------------------------
--y-------------y----------------
XXXXXXXXXXXXXXXXXXXXXXXXXX----XXX
XXXXXXXXXXXXXXXXXXXXXXXXXX----XXX