-----------------
-----------------
-----------------
-----------------
-----------------
------y----------
------##---------
----y###---------
----####---------
---#####---------
--######---C-----
-#######---------
########---------
########--------#
XXXXXXXXXXXXXXXXX
XXXXXXXXXXXXXXXXX