---------------------
---------------------
---------------------
---------------------
---------------------
---------------------
---------------------
-oooo------------oooo
---------------------
---------------------
--------------TT-----
--------------TT-----
--------------TT-----
---y------y---TT-----
XXXXXXXXXXXXXXXXXXXXX
XXXXXXXXXXXXXXXXXXXXX