----------------------
----------------------
----------------------
----------------------
----------------------
----------------------
----------------------
--oooo------------oooo
----------------------
----------------------
t--------------TT-----
t--------------TT-----
t--------------TT-----
t---y------y---TT-----
XXXXXXXXXXXXXXXXXXXXXX
XXXXXXXXXXXXXXXXXXXXXX