------------------------------------
------------------------------------
------------------------------------
------------------------------------
------------------------------------
------------------------------------
--------Q---------------------------
------------------------------------
------------------------------------
-------------------------oo---------
--------?---------------o--o--------
----TT------------------------------
----TT------------------------------
----TT------------------------------
XXXXXXXXXXXXXXX--XXXXXXXXXXXXXXXXXXX
XXXXXXXXXXXXXXX--XXXXXXXXXXXXXXXXXXX