-----------------------------
-----------------------------
-----------------------------
-----------------------------
-----------------------------
-----------------------------
---------QQQQ----------------
-----------------------------
-----------------------------
-----------y-----------------
-------QQ?SSQQQ--------------
-----------------------------
------------------------TT---
------------------------TT---
XXXXXXXXXX--XXXXXXXXXXXXXXXXX
XXXXXXXXXX--XXXXXXXXXXXXXXXXX