------------------
------------------
------------------
------------------
------------------
-------y----------
-------##---------
-----y###---------
-----####---------
----#####---------
---######---C-----
--#######---------
-########---------
#########--------#
XXXXXXXXXXXXXXXXXX
XXXXXXXXXXXXXXXXXX