---------------------------
---------------------------
---------------------------
---------------------------
---------------------------
---------------------------
---------------------------
---------------------------
---------------------------
---------------------------
---------------------------
-------#-------------------
-------#-------------------
-------#----y--y----------#
XXXXXXXX--XXXXXXXXXXXXXXXXX
XXXXXXXX--XXXXXXXXXXXXXXXXX