-------------------------
-------------------------
-------------------------
SSSSSSSSSSSSSSSSSSSSSSSSS
---------------------SS--
---------------------SS--
--------oooo-------SS----
-------------------SS----
------S-SSSS-U-----SS----
------SoS--SoS-----SS----
------SSS--SSS-----SSSS--
---------------------SS--
#--------------------SS--
#--------kk--------------
XXXXXXXXXXXXXXXXXXXXXXXXX
XXXXXXXXXXXXXXXXXXXXXXXXX