-------------------
-------------------
-------------------
SSSSSSSSSLSSSSSSSSS
-------------------
-------------------
----oooooo---------
-------------------
----SSSSSS---------
----SSSSSS---------
-------------------
-------------------
-------------------
----------------g-g
---XXXXXXXXXXXXXXXX
---XXXXXXXXXXXXXXXX