-----------------------
-----------------------
-----------------------
SSSSSSSSSSSSSSSSSSSSSSS
-SSSSSS--SSSS------SSSS
-SSSSSS--SSSS---g--SSSS
-----SS---S----SS------
-----SS---S----SS------
-----SS---S----SS------
-ooooSS---SoU--SC--g-g-
-SSSSSS---SSS--SS--SSSS
-----------------------
-----------------------
---k--g-g--------------
XXXXXXXXXXXXXXXXXXXXXXX
XXXXXXXXXXXXXXXXXXXXXXX