-----------------
-----------------
-----------------
-----------------
-----------------
-----------------
SSS--------------
-----------------
-----------------
-----SSSSSSU-----
-----------------
-----------------
SSS--------------
-------r---------
-----XXXXXXXX--XX
-----XXXXXXXX--XX