-----------------------
-----------------------
-----------------------
SSSSSSSSSSSSSSSSSSSSSSS
-----------------------
-----------------------
-----------------------
-----------------------
-----------------------
-------------------C---
@QQQQ--------#-#-------
-----------#-#-#-#---#-
-------g-#-#-#-#-#---#-
------g#-#-#-#-#-#-E-#-
XXXXXXXXXXXXXXXXXXXXXXX
XXXXXXXXXXXXXXXXXXXXXXX