-----------------------------------------
-----------------------------------------
-----------------------------------------
SSSSSSSSSSSSSSSSSSSSSSSSSSSSSSSSSSSSSSS--
-----------------------------------------
-----------------------------------------
-----------------------------------------
-----------------------------------------
-----------------------------------------
-----------------------------------------
----------tt------------------------g##--
----TT----tt-----------SS-----------###--
----TT----tt----TT-----SS---------g####--
-g--TT----tt--g-TT-----SS---------#####--
XXXXXXXXXXXXXXXXXXXXX--XX--XXXXXXXXXXXX--
XXXXXXXXXXXXXXXXXXXXX--XX--XXXXXXXXXXXX--