--------------------------------------------------------------------------------------------------------------------------------------------------------------------------------------------------------------------------------------
--------------------------------------------------------------------------------------------------------------------------------------------------------------------------------------------------------------------------------------
--------------------------------------------------------------------------------------------------------------------------------------------------------------------------------------------------------------------------------------
------SSSSSSSSSSSSSSSSSSSSSSS------------------------------------------------------------SSSSSSSSSSSSSSSSSSSSSSS-------------------------SSSSSSSSSSSSSSSSSSSSSSSSSSSSSSSSSSSSSSS------------------------------------------------------
-------SSSSSS--SSSS------SSSS-------------------------------------------------------------SSSSSS--SSSS------SSSS----------------------------------------------------------------------------------------------------------------------
-------SSSSSS--SSSS---g--SSSS--------------g-----------------------------------k----------SSSSSS--SSSS---g--SSSS----------------------------------------------------------------------------------------------------------------------
-----------SS---S----SS--------------------SSSSS-----SS-----------------------##--------------SS---S----SS--------------------##-------------------------------------------------------------------------##----------SSSS-------------
-----------SS---S----SS------------------------------------------------------###--------------SS---S----SS-------------------###-------------------------------------------------------------------------##---------------------------
-----------SS---S----SS---------------TT-----------------------#-----------k####--------------SS---S----SS------------------####-------------------------------------------------------------------------##---------------------------
-------ooooSS---SoU--SC--g-g----TT----TT-----------------k-----#-----------#####----------ooooSS---SoU--SC--g-g------------#####------------------------------------------------------------------K---#--##---------------------g-----
-------SSSSSS---SSS--SS--SSSS---TT----##---------------CSSS----#----------######----------SSSSSS---SSS--SS--SSSS----------######-------------------tt------------------------g##---------------------##--##---------------------tt----
--------------------------------TT----------------------K-----##---------#######-----------------------------------------#######-------------TT----tt-----------SS-----------###--------------------###--##---------------------tt----
--------------------------------TT---------TT-----tt----------##--------########----------------------------------------########-------------TT----tt----TT-----SS---------g####------*------------####-------------------------tt----
---------k--g-g---------------k-TT---------TT-----tt------K---##-------#########--------#---k--g-g-----------------ggg-#########--------S-g--TT----tt--g-TT-----SS---------#####------*-----K-----#####------------#------------tt----
XXXXXXXXXXXXXXXXXXXXXXXXXXXXXXXXXXXXXXXXXXXXXXXXXXXXXXXXXXXXXXXX---XXXXXXXXXXXXXXXXXXXXXXXXXXXXXXXXXXXXXXXXXXXXXXXXXXXXXXXXXXXXXXXXXXXXXXXXXXXXXXXXXXXXXXXXXXX--XX--XXXXXXXXXXXX--XXXXXXXXXXXXXXXXXXXXXXXXXXXXXXXXXXX----XXXXXXXXXXXXX
XXXXXXXXXXXXXXXXXXXXXXXXXXXXXXXXXXXXXXXXXXXXXXXXXXXXXXXXXXXXXXXX---XXXXXXXXXXXXXXXXXXXXXXXXXXXXXXXXXXXXXXXXXXXXXXXXXXXXXXXXXXXXXXXXXXXXXXXXXXXXXXXXXXXXXXXXXXX--XX--XXXXXXXXXXXX--XXXXXXXXXXXXXXXXXXXXXXXXXXXXXXXXXXX----XXXXXXXXXXXXX