----------------------------------------------------------------------------------------------------------------------------------------------------------------------------------------------------------------------------------
----------------------------------------------------------------------------------------------------------------------------------------------------------------------------------------------------------------------------------
----------------------------------------------------------------------------------------------------------------------------------------------------------------------------------------------------------------------------------
----------------------------------------------------------------------------------------------------------------------------------------------------------------------------------------------------------------------------------
----------------------------------------------------------------------------------------------------------------------------------------------------------------------------------------------------------------------------------
----------------------------------------------------------------------------------------------------------------------------------------------------------------------------------------------------------------------------------
---------------------------------US------------------------------------------QQQQQ----@-------------------------------SUS---------------------------------------------------------SS----S!!S-----------------------US-------------
---------oooo-------------------------------y-------------------------------------------------------------------------------------------------------------------------------------------------------------------------------------
--------------------------------------------S-------------------------------------------------------------------------------------------------------------------------------------------------------------------------------------
-------------------------------------------------------------------------------k--------------------------------------------------------------------------------------------------------------------------------------------------
--------------------------------###---SSC----SC-----------#-----------TT-----?QQQQ----@-------------------------------####---------------------------------------------------------------SS------#--#-------------###---SSC-------
----------tt---------------y-####-------------------------#-----------TT------------------------------------------------------------------------#-----------------------------------------------##--##-------y-####---------------
----------tt--------------#####---------------SSS---------##----------TT----------------#--------------------------------------------------*----#----------------------------------------------###--###-----#####-----------------
----------tt----k---ggg---###-----------------------------##---gg-----TT------------gg-k#------------K------------------------------ggg----*----#----ggg--k----ggg-------------kkk--gg-g-g----####--####----###-------------------
XXXXXXXXXXXXXXXXXXXXXXXXXXXX------XX--XXXXXX-----XXXXXXXXXXXXXXXXXXXXXXXXXXXXXXXXXXXXXXXX--XXXXXXXXXXXXXXXXXXXXXXXXXXXXX----XXXXXXXXXXXXXXXXXX--XXXXXXXXXXXXXXXXXXXXXXXXXXXXXXXXXXXXXXXXXXXXXXXXXXXXXXXXXXXXXX------XX--XXXXXXXXXX
XXXXXXXXXXXXXXXXXXXXXXXXXXXX------XX--XXXXXX-----XXXXXXXXXXXXXXXXXXXXXXXXXXXXXXXXXXXXXXXX--XXXXXXXXXXXXXXXXXXXXXXXXXXXXX----XXXXXXXXXXXXXXXXXX--XXXXXXXXXXXXXXXXXXXXXXXXXXXXXXXXXXXXXXXXXXXXXXXXXXXXXXXXXXXXXX------XX--XXXXXXXXXX