----------------------------------------------------------------------------------------------------------------------------------------------------------------------------------------------------------
----------------------------------------------------------------------------------------------------------------------------------------------------------------------------------------------------------
----------------------------------------------------------------------------------------------------------------------------------------------------------------------------------------------------------
----------------------------------------------------------------------------------------------------------------------------------------------------------------------------------------------------------
----------------------------------------------------------------------------------------------------------------------------------------------------------------------------------------------------------
-------------------------------------------------------------------------------------oo-------------------------------------------------------------------------------------------------------------------
------------------------------------------------------------------------------------@SS------------------------SS----S!!S----------------------1--------USS-------------1--------USS----------------------
----------------------------------------------------------------------------------------------------------------------------------------------------------------------------------------------------------
-------------------------------------------------TT-----------------##------------------------------------------------------------------------------------------------------------------------------------
-------------------------------------------------TT-------------g--###------------------SSS----------------------------------------------------ggg----------------------ggg-------------------------------
----------------------------------------#LSS-----##-------------#--###-------!!!!!-2----------------------------------SS------#--#-------##########---#-----------##########---#--------------------------
-------------#--------------------------#---------------------g##--###-------------------------------------------------------##--##------#--------#---#-----------#--------#---#--------------------------
-------------#--------------------------#-----------*---TT----###--###------------------------------------------------------###--###-----#--------#---##----------#--------#---##-------------------------
-------------#----y--y----------------kk#-----------*---TT---####--###------------------oo-----kkk-------kk------gg-g-g----####--####----#--------#---##--gg----k-#--------#---##--gg----k---------kkk----
XXXXXXXXXXXXXX--XXXXXXXXXXXXXXXXXXXXXXXXXXXXX---XXXXXXXXXXXXXXXXX--XXXXXXXXXXXXXXXXXXXXXXXXXXXXXXXXXXXXXXXXXXXXXXXXXXXXXXXXXXXXXXXXXXXXXXX--------X---XXXXXXXXXXXXX--------X---XXXXXXXXXXXXXXXXXXXXXXXXXXX
XXXXXXXXXXXXXX--XXXXXXXXXXXXXXXXXXXXXXXXXXXXX---XXXXXXXXXXXXXXXXX--XXXXXXXXXXXXXXXXXXXXXXXXXXXXXXXXXXXXXXXXXXXXXXXXXXXXXXXXXXXXXXXXXXXXXXX--------X---XXXXXXXXXXXXX--------X---XXXXXXXXXXXXXXXXXXXXXXXXXXX