------------------------------------------------------------------------------------------------------------------------------------------------------------------------------------------------------------------
------------------------------------------------------------------------------------------------------------------------------------------------------------------------------------------------------------------
------------------------------------------------------------------------------------------------------------------------------------------------------------------------------------------------------------------
------------------------------------------------------------------------------------------------------------------------------------------------------------------------------------------------------------------
------------------------------------------------------------------------------------------------------------------------------------------------------------------------------------------------------------------
------------------------------------------------------------------------------------------------------------------------------------------------------------------------------------------------------------------
-----------------------------------------------------------------------------@-------------------------------------------------------------------------------------------------------------------------##---------
------------------------------------------------------------@-----------------------------------------------------------------S-----------------------------------------oooo--------------------------###---------
-----------------------------------------------------------------------------------------------------------------------------------------------------------------------------------------------------####---------
----------------------------------------------------------------------------------------------------------------------------------------------------------------------------------------------------#####---------
-------------------------------------------------------ooo-------------------@---------------------------------------------------------------------------------------------------------------------######---------
------------------------------------------------------------#------------------------------------------------------------------------------------------------------------tt-----------------------#######---------
------------------------------------------------------------#--------------#---#----------------------------------------------#------------------------------------------tt----------------------########---------
-----------------k------ggg------kkk-------kk----#----------#-----k----ggg-#--k#------------K------------------k-------ggg----#-------k-----kkk-------kk----------kkk----tt----k---ggg------ggg-#########--------S
XXXXXXXXXXXXXXXXXXXXXXXXXXXXXXXXXXXXXXXXXXXXXXXXXXXXXXXXXXXXXXXXXXXXXXXXXXXXXXXX--XXXXXXXXXXXXXXXXXXXXXXXXXXXXXXXXXXXXXXXXX--XXX--XXXXXXXXXXXXXXXXXXXXXXXXXXXXXXXXXXXXXXXXXXXXXXXXXXXXXXXXXXXXXXXXXXXXXXXXXXXXXXXX
XXXXXXXXXXXXXXXXXXXXXXXXXXXXXXXXXXXXXXXXXXXXXXXXXXXXXXXXXXXXXXXXXXXXXXXXXXXXXXXX--XXXXXXXXXXXXXXXXXXXXXXXXXXXXXXXXXXXXXXXXX--XXX--XXXXXXXXXXXXXXXXXXXXXXXXXXXXXXXXXXXXXXXXXXXXXXXXXXXXXXXXXXXXXXXXXXXXXXXXXXXXXXXX