--------------------------------------------------------------------------------------------------------------------------------------------------------------------------------------------------------------------------------------------------------------------
--------------------------------------------------------------------------------------------------------------------------------------------------------------------------------------------------------------------------------------------------------------------
--------------------------------------------------------------------------------------------------------------------------------------------------------------------------------------------------------------------------------------------------------------------
----------SSSSSS------------------------------------------------------------------------------------------------SSS----------SSSSSSSSSSSSSSSSSSSSSSSSSSSSSSSSSSSSSSSSS---------------------------------------SSSSSSS-----SSSSS--------------------------------------
-------------------------------------------------------------------------------------------------------------------------------------------------------------------------------------------------------------------------SSSSS--------------------------------------
----------------------------------------------ooo--------------------------------------------g---------------------------------------------------------------------------------------------------------------------------SSSSS--------------------------------------
---------------------------LSSS-----------------------SSSSS@-------------------------------SSSSSSSS---SSS!----------------CSS-----------------------------------------------------2--------------------------------------SSSSS-----------------------##-------------
-------------------------------------------------------------------------------------------------------------------------------------------------------------------------------------------------------------------------S---------------------------##-------------
-----------------------g------------------B-----------------------------------------------g--------------------------SSS--2----------------------------------------------SS--------------------y-------------------------S---------------------------##-------------
-----------------------#------------------b-----------ooo------------------1---------------------------------------------2-2-----------------S-----------------------------oo------------------#SS-?Q----------------------ooo----------------K---#--##-------------
----------------S-----##---2-----#------####----------SSSSSS--------tt------------------S@S--------------C-----SQQQ---------2---------SC-------------------------TT---------------2-----------##--------------------------USSS-------------------##--##-------------
---------------------###---------#-----##---------------------------tt------------------------------------------------------------TT------TT---tt-------------#--TT--##----------------------###-------------------#----------------------------###--##-------------
--------------------####---------#----###---------------------------tt------------------------------------------------------------TT------TT---tt------------##--TT--##---------------------####-------y----------##-SSS----------*------------####-----------------
-------------------#####----kk---#---####-------k----------------K--tt------------------------------------g-g---------------------TT---k-kTT--ktt---------kk-##--TT--##---------y--y-------#####---SSSSS---------###--------------*-----K-----#####------------#----
XXXXXXXXXXXXXXX-XXXXXXXXXXXXXXXXXXXXXXXXXXXXXXXXXXX---XXXXXXXXXXXXXXXXXXXXXXXXXX--XXXXXXXXXXXXXXX---XXXXXXXXXXXXXXX------XXXXXXXXXXXXXXXXXXXXXXXXXXXXXXXXXXXXXX--XX--XX----XXXXXXXXXXXXXXXXXXXXX-------XX-XXXXXXXXXX-----XXXXXXXXXXXXXXXXXXXXXXXXXXXXXXXXXXXXXXXXXXX
XXXXXXXXXXXXXXX-XXXXXXXXXXXXXXXXXXXXXXXXXXXXXXXXXXX---XXXXXXXXXXXXXXXXXXXXXXXXXX--XXXXXXXXXXXXXXX---XXXXXXXXXXXXXXX------XXXXXXXXXXXXXXXXXXXXXXXXXXXXXXXXXXXXXX--XX--XX----XXXXXXXXXXXXXXXXXXXXX-------XX-XXXXXXXXXX-----XXXXXXXXXXXXXXXXXXXXXXXXXXXXXXXXXXXXXXXXXXX