--------------------------------
--------------------------------
--------------------------------
-----U--------------------------
--------------------------------
-----------------------k--------
-----------------------##-------
-------SS-------------###-------
------------#--------####-------
---SS------##-------#####-------
----------###------######-------
B--------####-----#######-------
b-------#####----########-------
B------######---#########-------
XXXXXX-XXXXXXXXXXXXXXXXXXXXXXXXX
XXXXXX-XXXXXXXXXXXXXXXXXXXXXXXXX