-----------------------------------
-----------------------------------
-----------------------------------
-----------------------------------
-----------------------------------
-------K---------------------------
--SSSSSSS----1---------------------
-----------------------------------
-----------------------------------
----K------------------------------
--SSSSSSS--------------------------
-------------TT--------------TT----
-------------TT---------B----TT----
-------------TT---------b----TT-k--
XXXXXXXXXXXXXXXXXXXXXXXXXXXXXXXXXXX
XXXXXXXXXXXXXXXXXXXXXXXXXXXXXXXXXXX