-------------------------
-------------------------
-------------------------
-------------------------
-------------------------
-------------------------
-------------------------
-------------------------
--------B----------------
--------b----------------
------SS#CS--------------
B-------------------TT---
b---------K-B-------TT---
B-----------b-------TT---
XXXXXXXXXXXXXXXXX--XXXXXX
XXXXXXXXXXXXXXXXX--XXXXXX