------------------
------------------
------------------
------------------
------------------
------------------
------------------
------------------
------------------
------------------
------------------
------------------
-TT-----B-----TT--
-TT-----b-----TT--
XXXXXXXXXXXXXXXXXX
XXXXXXXXXXXXXXXXXX