----------------------------------------
----------------------------------------
----------------------------------------
----------------------------------------
----------------------------------------
----------------------------------------
-----------USS--------------------------
----------------------------------------
----------------------------------------
----------------------------------------
-----------------------QQQQ-------------
--------K---B---------------K-B-----K---
---B--------b-------B---------b---------
---b--------B-------b---------b---------
XXXXXXXXXXXXXXXXXXXXXXXXXXXXXXXXXXXXXXXX
XXXXXXXXXXXXXXXXXXXXXXXXXXXXXXXXXXXXXXXX