---------------
---------------
---------------
---------------
---------------
---------------
---SSSSS-------
---------------
---------------
----K----------
---SSSSS-------
------K---#----
----------#----
----------#----
XXXXXXXXXXXXXXX
XXXXXXXXXXXXXXX