--------------------------
--------------------------
--------------------------
--------------------------
--------------------------
--------------g-----------
--------------SSSSS-----SS
--------------------------
---------TT---------------
---TT----TT---------------
---TT----##---------------
---TT---------------------
---TT---------TT-----tt---
-k-TT---------TT-----tt---
XXXXXXXXXXXXXXXXXXXXXXXXXX
XXXXXXXXXXXXXXXXXXXXXXXXXX