-------------------
-------------------
-------------------
-------------------
------------------K
-------------------
------------------#
-----------------##
----------------###
---------------####
-------------TT####
-TT----------TT####
-TT---------#TT####
-TT--------##TT####
XXXXXXXXXXXXXXXXXXX
XXXXXXXXXXXXXXXXXXX