---------------
---------------
---------------
---------------
---------------
---------------
---------------
---------------
---------------
---------------
-------tt---SU-
----K--tt------
-------tt------
-------tt------
XXXXXXXXXXXXXXX
XXXXXXXXXXXXXXX