-----------
-----------
-----------
-----------
-----------
-----------
SSS--------
-----------
--------TT-
--------TT-
---2----TT-
-TT-----TT-
-TT--TT-TT-
-TT--TT-TT-
XXXXXXXXXXX
XXXXXXXXXXX