-----------
-----------
-----------
-----------
K----------
-----------
##---------
##---------
##---------
##---------
##---------
##---------
##---------
##--------#
XXXXXXXXXXX
XXXXXXXXXXX