---------------------------------------------------------------
---------------------------------------------------------------
---------------------------------------------------------------
---------------------------------------------------------------
---------------------------------------------------------------
---------------------------------------------------------------
SS------------US---SS-------------SSS--------------------------
-----------------------------------------TT--------------------
-----------------------------------------TT--------------------
------------SS---------------------------TT--------------------
------------------SSS---------#---SSS----##-----TT-------TT----
-------------------------#-TT-#-----------------TT-----TTTT----
-----TT--TT-------------##-TT-##----------------TT---TTTTTT----
-----TT--TT------------###-TT-##---------k--g---TT---TTTTTT----
---XXXXXXXXXXXX-X-XXXXXXXX-XXXXXXXXXXXXXXXXXXXXXXXXXXXXXXXXXXXX
---XXXXXXXXXXXX-X-XXXXXXXX-XXXXXXXXXXXXXXXXXXXXXXXXXXXXXXXXXXXX