------------
------------
------------
------------
------------
------------
------------
-----TT-----
-----TT-----
-----##-----
-TT---------
-TT---------
-TT-----TTTT
-TT-----TTTT
XXXXXXXXXXXX
XXXXXXXXXXXX