-------------
-------------
-------------
-------------
-------------
-------------
---------SCS-
-------------
-------------
-------------
-----tt---2--
-----tt------
-----tt------
-----tt----k-
XXXXXXXXXXXXX
XXXXXXXXXXXXX