-------------------------------------
-------------------------------------
-------------------------------------
-------------------------------------
-------------------------------------
-------------------------------k-----
--------------------------S---SSSSSSS
----------------------TT-------------
----------------------TT-------------
----------------------TT-------------
-------------tt------S##S------------
-----TT------tt----------------------
-----TT------tt-TT--------TT---------
---k-TT------tt-TT--------TT---------
XXXXXXXXXXXXXXXXXXXXXXXXXXXXXXXXXX---
XXXXXXXXXXXXXXXXXXXXXXXXXXXXXXXXXX---