-------------------------------------------------------------------------------------------------------------------------------------------------------------------------------------------------
-------------------------------------------------------------------------------------------------------------------------------------------------------------------------------------------------
-------------------------------------------------------------------------------------------------------------------------------------------------------------------------------------------------
-------------------------------------------------------------------------------------------------------------------------------------------------------------------------------------------------
-------------------------------------------------------------------------------------------------------------------------------------------------------------------------------------------------
--------------------------------------------------------------------------g-------------------------------------------------------------------------------------------------------y--------------
----------------------SS----S!!S----------------------------------------SSSSSSSS---SSS!-----------------------------------------------1--------USS-------SSSSS---?----------------##-------------
------------------------------------------------------------------------------------------------------------------y-------------------------------------------------------------y###-------------
-----------------------------------------------------------------------g------------------------------------------S-------------------------------------------------------------####-------------
--------------------------------------------------------1-----------------------------------------------------------------------------ggg--------------------------------------#####-------------
-------------------!---------SS------#--#--------tt------------------S@S--------------C-----S------------------C---SC-----------##########---#-----------------Q--------------######---C---------
------------------------------------##--##-------tt-----------------------------------------------------#-----------------------#--------#---#-----------------------TT------#######-------------
-----------------------------------###--###------tt-------------------------------------------------K---#-----------SSS---------#--------#---##----------------------TT-----########-------------
------------------------gg-g-g----####--####-----tt------------------------------------g-g--------------#-----gg----------------#--------#---##--gg----k------K-K----TT----#########--------#----
XXXXXXXXXXXXXXXXXXXXXXXXXXXXXXXXXXXXXXXXXXXXXXXXXXXXXXXXXXXXX--XXXXXXXXXXXXXXX---XXXXXXXXXXXXXXXXXXXXX--XXXXXXXXXX-----XXXXXXXXXX--------X---XXXXXXXXXXXXXXXXXXXXXXXXXXXXXXXXXXXXXXXXXXXXXXXXXXXX
XXXXXXXXXXXXXXXXXXXXXXXXXXXXXXXXXXXXXXXXXXXXXXXXXXXXXXXXXXXXX--XXXXXXXXXXXXXXX---XXXXXXXXXXXXXXXXXXXXX--XXXXXXXXXX-----XXXXXXXXXX--------X---XXXXXXXXXXXXXXXXXXXXXXXXXXXXXXXXXXXXXXXXXXXXXXXXXXXX