-----------------------------------------------------------------------------------------------------------------------------------------------------------------------------------------------------------------------------------------------------------------
-----------------------------------------------------------------------------------------------------------------------------------------------------------------------------------------------------------------------------------------------------------------
-----------------------------------------------------------------------------------------------------------------------------------------------------------------------------------------------------------------------------------------------------------------
---------------------------SSSSSSS-----SSSSS-----------------------------------------------------------------------------------------------------------------------------------------------------------------------------------------SSS----------SSSSSSSSSSS----
---------------------------------------SSSSS---------------------------------------------------------------------------------------------------------------------------------------------------------------------------------------------------------------------
---------------------------------------SSSSS--------------------------------------------r----------------------------------------------------------------------------------------------------y-------------------------------------------------------------------
---------------------------------------SSSSS----------------------------------------SSSSS----------------------------------------------------------------------------------------------------##------------------QQQQ--------------------------CSS---------------
---------------------------------------S---------------------------------------------------------------------S--------------------------------------------S--------------------------------y###------------------------------------------------------------------
---------------------------------------S---------------------------------------------------------------------------------------------------------------------------------------------------####-------------------------------------------SSS--2-----------------
-----------------------------------------ooo----------------------------------------------------------------------------------------------------------------------------------------------#####--------------------y--------------------------2-2----------------
------------------------C---------------USSS------------------C---------------SSS--------------------------------------------------------------------------------------------------------######---C------------QQ?SSQQQ--------------QQQ---------2---------SC----
-----------------#---------------#---------------------#--------------------------------------------------------------------------------------------------------------------------------#######--------------------------------------------------------TT--------
-------------K---#--------------##-SSS-------------K---#----------------@@-----------------------------------#--------------------------------------------#----------------------------########---------------------------------TT---------------------TT--------
-----------------#-----gg------###---------------------#-----gg----ggg----------------gg------k-------ggg----#-------k-----kkk-------kk----k-------ggg----#-------k-----kkk-------kk--#########--------#------------------------TT---------------------TT---k----
XXXXXXXXXXXXXXX--XXXXXXXXXXXXXXXXX-----XXXXXXXXXXXXXX--XXXXXXXXXXXXXXXXXXXX-------XXXXXXXXXXXXXXXXXXXXXXXX--XXX--XXXXXXXXXXXXXXXXXXXXXXXXXXXXXXXXXXXXXX--XXX--XXXXXXXXXXXXXXXXXXXXXXXXXXXXXXXXXXXXXXXXXXXXXXXXXXXX--XXXXXXXXXXXXXXXXXXXX------XXXXXXXXXXXXXXXXXXX
XXXXXXXXXXXXXXX--XXXXXXXXXXXXXXXXX-----XXXXXXXXXXXXXX--XXXXXXXXXXXXXXXXXXXX-------XXXXXXXXXXXXXXXXXXXXXXXX--XXX--XXXXXXXXXXXXXXXXXXXXXXXXXXXXXXXXXXXXXX--XXX--XXXXXXXXXXXXXXXXXXXXXXXXXXXXXXXXXXXXXXXXXXXXXXXXXXXX--XXXXXXXXXXXXXXXXXXXX------XXXXXXXXXXXXXXXXXXX