----------------------------------------------------------------------------------------------------------------------------------------------------------------------------------------------------------------------------------
----------------------------------------------------------------------------------------------------------------------------------------------------------------------------------------------------------------------------------
----------------------------------------------------------------------------------------------------------------------------------------------------------------------------------------------------------------------------------
----------------------------------------------------------------------------------------------------------------------------------------------------------------------------------------------------------------------------------
----------------------------------------------------------------------------------------------------------------------------------------------------------------------------------------------------------------------------------
-------------------------------------------------------------------------------------oo----------------------------------------------------------------------------------------------------------oo-------------------------------
------------------------------------------------SS----------------------------------@SS-------!-------------------------------------------------------------1------------------------------------SSSS-------SSSSS---?-------------
-------------------------------------------------------------------------------------------------------------------------------------------------------------------------oooo-----------------------------------------------------
--------------------------------------------------------------------##------------------------------------------------------------------------------------------------------------------------------------------------------------
---------------------S------------------------------------------g--###------------------SSS---------------------------------------------------------------------------------------------------------------------------------------
---------##--#----------------------------------SS--------------#--###-------!!!!!-2--------S@S!S---------------------tt--------------##------------------QQQQ----------------------tt-------@--------------------Q---------------
--------###--##-----------------------------------------------g##--###----------------------------------------tt------tt-------------###------tt-----------------------#------------tt----------------------------------TT--------
-------####--###---------------------B-------tt---------------###--###------------------------------tt--------tt------tt------------#####-----tt-----------------------#------------tt--K---------tt--------------------TT--------
------#####--####-------------------Kb-------tt--------------####--###------------------oo---g------tt--------tt-g----tt-----g-g---######-----tt-----------yy----------#---------y--tt-----K------tt-------------K-K----TT--------
XXXXXXXXXXX--XXXXXXXXX----XXXXXXXXXXXXXXXXXXXXXXXXXXXXXXXXXXXXXXX--XXXXXXXXXXXXXXXXXXXXXXXXXXXXXXXXXXXXXXXXXXXXXXXXXXXXXXXXXXXXXXXXXXXXXXXXXXXXXXXXXXXXXXXXXXXXXXXXXXXXXXXXXXXXXXXXXXXXXXXXXXXX---XX--XXXXXXXXXXXXXXXXXXXXXXXXXXXX
XXXXXXXXXXX--XXXXXXXXX----XXXXXXXXXXXXXXXXXXXXXXXXXXXXXXXXXXXXXXX--XXXXXXXXXXXXXXXXXXXXXXXXXXXXXXXXXXXXXXXXXXXXXXXXXXXXXXXXXXXXXXXXXXXXXXXXXXXXXXXXXXXXXXXXXXXXXXXXXXXXXXXXXXXXXXXXXXXXXXXXXXXX---XX--XXXXXXXXXXXXXXXXXXXXXXXXXXXX