----------------------------------------------------------------------------------------------------------------------------------------------------------------------------
----------------------------------------------------------------------------------------------------------------------------------------------------------------------------
----------------------------------------------------------------------------------------------------------------------------------------------------------------------------
----------------------------------------------------------------------------------------------------------------------------------------------------------------------------
----------------------------------------------------------------------------------------------------------------------------------------------------------------------------
---------------------------------------------------------------------------oo-----------------------------------------------------------------------------------------------
-------------------------------------------LSSS---------------------------@SS----------------------------------##---------------1--------USS---------------------C----------
--------------------------------------------------------------------------------------------------------------###-----------------------------------------------------------
---------------------------------------g------------------##-------------------------------------------------####-----------------------------------------------------------
---------------------------------------#--------------g--###------------------SSS---------------------------#####---------------ggg-----------------------------------------
--------------------------------S-----##---2-----#----#--###-------!!!!!-2--------------------!------------######---------##########---#------------------------SS----------
-------------#-----------------------###---------#--g##--###----------------------------------------------#######---------#--------#---#------------------------------------
-------------#----------------------####---------#--###--###---------------------------------------------########---------#--------#---##-----------------------------------
-------------#----y--y-------------#####----kk---#-####--###------------------oo--------------------ggg-#########--------S#--------#---##--gg----k---------------k-----X----
XXXXXXXXXXXXXX--XXXXXXXXXXXXXXXXXXXXXXXXXXXXXXXXXXXXXXX--XXXXXXXXXXXXXXXXXXXXXXXXXXXXXXXXXXXXXXXXXXXXXXXXXXXXXXXXXXXXXXXXXX--------X---XXXXXXXXXXXXXXXXXXXXXXXXXXXXXXXXXXXXX
XXXXXXXXXXXXXX--XXXXXXXXXXXXXXXXXXXXXXXXXXXXXXXXXXXXXXX--XXXXXXXXXXXXXXXXXXXXXXXXXXXXXXXXXXXXXXXXXXXXXXXXXXXXXXXXXXXXXXXXXX--------X---XXXXXXXXXXXXXXXXXXXXXXXXXXXXXXXXXXXXX