-------------------------------------------------
-------------------------------------------------
-------------------------------------------------
-------------------------------------------------
-------------------------------------------------
-------------------------------------------------
SUS----------------------------------------------
-------------------------------------------------
-------------------------------------------------
-------------------------------------------------
####---------------------------------------------
--------------------------#----------------------
---------------------*----#----------------------
--------------ggg----*----#----ggg--k----ggg-----
XX----XXXXXXXXXXXXXXXXXX--XXXXXXXXXXXXXXXXXXXXXXX
XX----XXXXXXXXXXXXXXXXXX--XXXXXXXXXXXXXXXXXXXXXXX