------------
------------
------------
------------
------------
------------
------------
------------
------------
------------
------------
------------
------------
------ggg---
XXXXXXXXXXXX
XXXXXXXXXXXX