------------------
------------------
------------------
------------------
------------------
------------------
------------------
------------------
------------------
------------------
------------------
------------------
------------------
---------k---ggg--
XXXXXXXXXXXXXXXXXX
XXXXXXXXXXXXXXXXXX