----------------------------------
----------------------------------
----------------------------------
----------------------------------
----------------------------------
----------------------------------
-----------------------##---------
-----------------------##---------
-----------------------##---------
----------------K---#--##---------
-------------------##--##---------
------------------###--##---------
----*------------####-------------
----*-----K-----#####------------#
XXXXXXXXXXXXXXXXXXXXXXXXXXXXXXXXXX
XXXXXXXXXXXXXXXXXXXXXXXXXXXXXXXXXX