-----------
-----------
-----------
-----------
-----------
-----------
-----------
-----------
-----------
-----------
-----------
---------TT
---------TT
-------kkTT
XXXXXXXXXXX
XXXXXXXXXXX