----------------------------
----------------------------
----------------------------
----------------------------
----------------------------
----------------------------
----------------------------
----------------------------
-----------------TT---------
-----------------TT---------
--------#LSS-----##---------
--------#-------------------
--------#-----------*---TT--
------kk#-----------*---TT--
XXXXXXXXXXXXX---XXXXXXXXXXXX
XXXXXXXXXXXXX---XXXXXXXXXXXX