---------------------
---------------------
---------------------
---------------------
---------------------
---------------------
---------------------
---------------------
---------------------
---------------------
--------------------#
--------------------#
-------------------K#
-----ggg------------#
XXXXXXXXXXXXXXXXXXXXX
XXXXXXXXXXXXXXXXXXXXX