---------------------------------------------------------------------------------------------------------------------------------------------------------------------------------------------
---------------------------------------------------------------------------------------------------------------------------------------------------------------------------------------------
---------------------------------------------------------------------------------------------------------------------------------------------------------------------------------------------
-------------------------------------------------------------------------------------------------------------------------------------------------------------------------------------SSSS----
---------------------------------------------------------------------------------------------------------------------------------------------------------------------------------------------
-------------------------------------------------------------------------------------g-------------------------------------------------------------------------------------------------------
-------------1---------------------------------------------------------------------SSSSSSSS---SSS!-----------------------------------------------1--------USS--------------------------------
--------------------------oooo------------oooo----------------------------------------------------------y--------------oooo------------oooo--------------------------------------------------
----------------------------------------------------------------------------------g---------------------S------------------------------------------------------------------------------------
-------------------------------------------------------------------1-----------------------------------------------------------------------------ggg-----------------------------------------
-----------QQQQ----------------------tt---------------------tt------------------S@S--------------C-----S-SC-------------------------TT-----##########---#------------------------------------
------------------------#------------tt----tt---------------tt----------------------------------------------------------------------TT-----#--------#---#------------------------------------
------------------------#------------tt----tt---------------tt--------------------------------------------SSS-----------------------TT-----#--------#---##-----------------------------------
------------yy----------#---------y--tt----tt----k---ggg----tt------------------------------------g-g--------------------y------y---TT-----#--------#---##--gg----k--------------------------
XXXXXXXXXXXXXXXXXXXXXXXXXXXXXXXXXXXXXXXXXXXXXXXXXXXXXXXXXXXXXXXXXXXXXXXX--XXXXXXXXXXXXXXX---XXXXXXXXXXXX-----XXXXXXXXXXXXXXXXXXXXXXXXXXXXXXX--------X---XXXXXXXXXXXXXXXXXX---XXX--XXXXXXXXXXX
XXXXXXXXXXXXXXXXXXXXXXXXXXXXXXXXXXXXXXXXXXXXXXXXXXXXXXXXXXXXXXXXXXXXXXXX--XXXXXXXXXXXXXXX---XXXXXXXXXXXX-----XXXXXXXXXXXXXXXXXXXXXXXXXXXXXXX--------X---XXXXXXXXXXXXXXXXXX---XXX--XXXXXXXXXXX