------------------------------------------------------------------------------------------------------------------------------------------------------------------------------------------------------------------------------------------------------
------------------------------------------------------------------------------------------------------------------------------------------------------------------------------------------------------------------------------------------------------
------------------------------------------------------------------------------------------------------------------------------------------------------------------------------------------------------------------------------------------------------
------------------------------------------------------------------------------------------------------------------------------------------------------------------------------------------------------------------------------------------------------
------------------------------------------------------------------------------------------------------------------------------------------------------------------------------------------------------------------------------------------------------
------------------------------------------------------------------------------------------------------------------------------------------------------------------------------------------------------------------------------------------------------
-----------------LSSS---------------------------------@-----------S-------------------SUS----------------------------------------------SUS------------------------------------------------------------------------------SS----S!!S--------------------
------------------------------------------------------------------------------------------------------------------------------------------------------------------------------------------------------------------------------------------------------
-------------g----------------------------------------------------------------------------------------------------------------------------------------------------------------------------------------------------------------------------------------
-------------#----------------------------------------------------------------Q--?--------------------------------------------------------------------------------------------------------------------------------------------------------------------
------S-----##---2-----#--------------------#SU----!--!--!-----S-----------Q---------S####---------------------------------------------####--------------------------------------------------------------------------C---------SS------#--#-----------
-----------###---------#--------------------#-------------------------------------------------------------------#------------------------------------------------#--------------------------------------------#-----------------------##--##----------
----------####---------#-------------------K#--------------------------------------------------------------*----#-------------------------------------------*----#----------------------------------------K---#----------------------###--###---------
---------#####----kk---#-----ggg------------#------k--------------------------------K---------------ggg----*----#----ggg--k----ggg-------------------ggg----*----#----ggg--k----ggg-------------kkk-----------#-----gg----gg-g-g----####--####--------
XXXXXXXXXXXXXXXXXXXXXXXXXXXXXXXXXXXXXXXXXXXXXXXXXXXXXXXXXXXXXXXXXXXXXXXXXXXXXXXXXXXXXXXX----XXXXXXXXXXXXXXXXXX--XXXXXXXXXXXXXXXXXXXXXXXXX----XXXXXXXXXXXXXXXXXX--XXXXXXXXXXXXXXXXXXXXXXXXXXXXXXXXXXXXXXXXXXX--XXXXXXXXXXXXXXXXXXXXXXXXXXXXXXXXXXXXXXXX
XXXXXXXXXXXXXXXXXXXXXXXXXXXXXXXXXXXXXXXXXXXXXXXXXXXXXXXXXXXXXXXXXXXXXXXXXXXXXXXXXXXXXXXX----XXXXXXXXXXXXXXXXXX--XXXXXXXXXXXXXXXXXXXXXXXXX----XXXXXXXXXXXXXXXXXX--XXXXXXXXXXXXXXXXXXXXXXXXXXXXXXXXXXXXXXXXXXX--XXXXXXXXXXXXXXXXXXXXXXXXXXXXXXXXXXXXXXXX