-------------------------------------------------------------------------------------------------------------------------------------------------------------------------------------------------------------------------------------------------
-------------------------------------------------------------------------------------------------------------------------------------------------------------------------------------------------------------------------------------------------
-------------------------------------------------------------------------------------------------------------------------------------------------------------------------------------------------------------------------------------------------
-------------------------------------------------------------------------------------------------------------------------------------------------------------------------------------------------------------------------------------------------
-------------------------------------------------------------------------------------------------------------------------------------------------------------------------------------------------------------------------------------------------
-----------------k--------------------------------------------------------------oo---------------------------------------------------------------------------------------------------------------------------------------------------------------
----------------SQS--SQS-------------------------------------------------------@SS----SS------------US---SS-------------SSS-------------------------------------------2-----------------------------------------------------------##-------------
-------------------------------------------------------------------------------------------------------------------------------TT-------------------------------------------------------------------------------------------------##-------------
---------------------------------------------------------------##--------------------------------------------------------------TT--------------------------------------------------y----------------------------------------------##-------------
-----------------------------------------------------------g--###------------------SSS------------SS---------------------------TT------------------------------oo------------------#SS-?Q----------------------------------K---#--##-------------
----------------SQS--S?S--------SC--------------------#----#--###-------!!!!!-2-------------------------SSS---------#---SSS----##-----TT-------TT---------SSS---------2-----------##------------------SSS---------------------##--##-------------
------------------------------------------------------#--g##--###----------------------------------------------#-TT-#-----------------TT-----TTTT--------------------------------###-----------------------------------------###--##-------------
-----------------------------------------------------K#--###--###--------------------------TT--TT-------------##-TT-##----------------TT---TTTTTT-------------------------------####-------y-------------------*------------####-----------------
---------------------ggg--------K------ggg------------#-####--###------------------oo------TT--TT------------###-TT-##---------k--g---TT---TTTTTT-------------------y--y-------#####---SSSSS-------------------*-----K-----#####------------#----
XXXXXXXXXXXXXXXXXXXXXXXXXXXXXXXXXXXXXXXXXXXXXXXXXXXXXXXXXXXX--XXXXXXXXXXXXXXXXXXXXXXXX---XXXXXXXXXXXX-X-XXXXXXXX-XXXXXXXXXXXXXXXXXXXXXXXXXXXXXXXXXXXXXXXXXXXXXXXXXXXXXXXXXXXXXXXXXXX-------XX-XXXXXXXXXXXXXXXXXXXXXXXXXXXXXXXXXXXXXXXXXXXXXXXXXXX
XXXXXXXXXXXXXXXXXXXXXXXXXXXXXXXXXXXXXXXXXXXXXXXXXXXXXXXXXXXX--XXXXXXXXXXXXXXXXXXXXXXXX---XXXXXXXXXXXX-X-XXXXXXXX-XXXXXXXXXXXXXXXXXXXXXXXXXXXXXXXXXXXXXXXXXXXXXXXXXXXXXXXXXXXXXXXXXXX-------XX-XXXXXXXXXXXXXXXXXXXXXXXXXXXXXXXXXXXXXXXXXXXXXXXXXXX