---------------------------------------------
---------------------------------------------
---------------------------------------------
---------------------------------------------
---------------------------------------------
--------------------------g------------------
------------------------SSSSSSSS---SSS!------
---------------------------------------------
-----------------------g---------------------
--------1------------------------------------
-tt------------------S@S--------------C-----S
-tt------------------------------------------
-tt------------------------------------------
-tt------------------------------------g-g---
XXXXXXXXXXXXX--XXXXXXXXXXXXXXX---XXXXXXXXXXXX
XXXXXXXXXXXXX--XXXXXXXXXXXXXXX---XXXXXXXXXXXX