----------------
----------------
----------------
----------------
----------------
----------------
----------------
----------------
----------------
----------------
-------------!--
----------------
----------------
----------------
XXXXXXXXXXXXXXXX
XXXXXXXXXXXXXXXX