---------------
---------------
---------------
---------------
---------------
---------------
---------------
---------------
---------------
---------------
---##--#-------
--###--##------
-####--###-----
#####--####----
XXXXX--XXXXXXXX
XXXXX--XXXXXXXX