----------------------
----------------------
----------------------
----------------------
----------------------
----------------------
---------@-----------S
----------------------
----------------------
----------------------
SU----!--!--!-----S---
----------------------
----------------------
------k---------------
XXXXXXXXXXXXXXXXXXXXXX
XXXXXXXXXXXXXXXXXXXXXX