---------------
---------------
---------------
---------------
---------------
---------------
---------------
---------------
---------------
---------------
--##--#--------
-###--##-------
####--###-----t
####--####----t
XXXX--XXXXXXXXX
XXXX--XXXXXXXXX