--------------------------
--------------------------
--------------------------
--------------------------
--------------------------
--------------------------
SS----S!!S----------------
--------------------------
--------------------------
--------------------------
-------SS------#--#-------
--------------##--##------
-------------###--###-----
--gg-g-g----####--####----
XXXXXXXXXXXXXXXXXXXXXXXXXX
XXXXXXXXXXXXXXXXXXXXXXXXXX