----------------------------
----------------------------
----------------------------
----------------------------
----------------------------
----------------------------
-----------------##---------
----------------###---------
---------------####---------
--------------#####---------
S------------######---------
------------#######---------
--------tt-########---------
---gg---tt#########--------#
XXXXXXXXXXXXXXXXXXXXXXXXXXXX
XXXXXXXXXXXXXXXXXXXXXXXXXXXX