---------------------------
---------------------------
---------------------------
---------------------------
---------------------------
---------------------------
SS----S!!S-----------------
---------------------------
---------------------------
---------------------------
-------SS------#--#--------
--------------##--##-------
-------------###--###------
--gg-g-g----####--####----#
XXXXXXXXXXXXXXXXXXXXXXXXXXX
XXXXXXXXXXXXXXXXXXXXXXXXXXX