--------------------------------------
--------------------------------------
--------------------------------------
--------------------------------------
--------------------------------------
--------------------------------------
---!----------------------------------
--------------------------------------
--------------------------------------
--------------------------------------
-S@S!S---------------------tt---------
-------------------tt------tt---------
---------tt--------tt------tt---------
--g------tt--------tt-g----tt-----g-g-
XXXXXXXXXXXXXXXXXXXXXXXXXXXXXXXXXXXXXX
XXXXXXXXXXXXXXXXXXXXXXXXXXXXXXXXXXXXXX