---------
---------
---------
---------
---------
---------
---------
---------
---------
---------
-----SS!S
---------
tt-------
tt-------
XXXXXXXXX
XXXXXXXXX